PokerStars Hand #109564154582:  Hold'em No Limit (€0.01/€0.02 EUR) - 2014/01/04 12:44:36 CET [2014/01/04 6:44:36 ET]
Table 'Ambrosia III' 6-max Seat #3 is the button
Seat 1: SebIsGood (€5.41 in chips) 
Seat 2: elamigo63 (€1.47 in chips) 
Seat 3: Gunt101 (€0.69 in chips) 
Seat 4: Sharky-Nadal (€2 in chips) 
Seat 5: mikrethor (€2 in chips) 
Seat 6: DiMiTiA (€1.83 in chips) 
Sharky-Nadal: posts small blind €0.01
mikrethor: posts big blind €0.02
*** HOLE CARDS ***
Dealt to mikrethor [Jh 2d]
DiMiTiA: folds 
SebIsGood: raises €0.05 to €0.07
elamigo63: folds 
Gunt101: calls €0.07
Sharky-Nadal: calls €0.06
mikrethor: folds 
*** FLOP *** [9d 3s Jc]
Sharky-Nadal: checks 
SebIsGood: bets €0.22
Gunt101: folds 
Sharky-Nadal: folds 
Uncalled bet (€0.22) returned to SebIsGood
SebIsGood collected €0.22 from pot
*** SUMMARY ***
Total pot €0.23 | Rake €0.01 
Board [9d 3s Jc]
Seat 1: SebIsGood collected (€0.22)
Seat 2: elamigo63 folded before Flop (didn't bet)
Seat 3: Gunt101 (button) folded on the Flop
Seat 4: Sharky-Nadal (small blind) folded on the Flop
Seat 5: mikrethor (big blind) folded before Flop
Seat 6: DiMiTiA folded before Flop (didn't bet)



PokerStars Hand #109564172784:  Hold'em No Limit (€0.01/€0.02 EUR) - 2014/01/04 12:45:09 CET [2014/01/04 6:45:09 ET]
Table 'Ambrosia III' 6-max Seat #4 is the button
Seat 1: SebIsGood (€5.56 in chips) 
Seat 2: elamigo63 (€1.47 in chips) 
Seat 3: Gunt101 (€0.62 in chips) 
Seat 4: Sharky-Nadal (€2 in chips) 
Seat 5: mikrethor (€1.98 in chips) 
Seat 6: DiMiTiA (€1.83 in chips) 
mikrethor: posts small blind €0.01
DiMiTiA: posts big blind €0.02
*** HOLE CARDS ***
Dealt to mikrethor [Qh 9c]
SebIsGood: folds 
elamigo63: raises €0.10 to €0.12
Gunt101: folds 
Sharky-Nadal: folds 
mikrethor: folds 
DiMiTiA: folds 
Uncalled bet (€0.10) returned to elamigo63
elamigo63 collected €0.05 from pot
*** SUMMARY ***
Total pot €0.05 | Rake €0 
Seat 1: SebIsGood folded before Flop (didn't bet)
Seat 2: elamigo63 collected (€0.05)
Seat 3: Gunt101 folded before Flop (didn't bet)
Seat 4: Sharky-Nadal (button) folded before Flop (didn't bet)
Seat 5: mikrethor (small blind) folded before Flop
Seat 6: DiMiTiA (big blind) folded before Flop



PokerStars Hand #109564182430:  Hold'em No Limit (€0.01/€0.02 EUR) - 2014/01/04 12:45:26 CET [2014/01/04 6:45:26 ET]
Table 'Ambrosia III' 6-max Seat #5 is the button
Seat 1: SebIsGood (€5.56 in chips) 
Seat 2: elamigo63 (€1.50 in chips) 
Seat 3: Gunt101 (€0.62 in chips) 
Seat 4: Sharky-Nadal (€2 in chips) 
Seat 5: mikrethor (€1.97 in chips) 
Seat 6: DiMiTiA (€1.81 in chips) 
DiMiTiA: posts small blind €0.01
SebIsGood: posts big blind €0.02
*** HOLE CARDS ***
Dealt to mikrethor [Qd Ad]
elamigo63: folds 
Gunt101: folds 
Sharky-Nadal: folds 
mikrethor: raises €0.10 to €0.12
DiMiTiA: folds 
SebIsGood: calls €0.10
*** FLOP *** [2c 7h Ts]
SebIsGood: checks 
mikrethor: checks 
*** TURN *** [2c 7h Ts] [Th]
SebIsGood: bets €0.10
mikrethor: raises €0.10 to €0.20
SebIsGood: calls €0.10
*** RIVER *** [2c 7h Ts Th] [5s]
SebIsGood: bets €0.30
mikrethor: calls €0.30
*** SHOW DOWN ***
SebIsGood: shows [6s Kc] (a pair of Tens)
mikrethor: shows [Qd Ad] (a pair of Tens - Ace kicker)
mikrethor collected €1.17 from pot
*** SUMMARY ***
Total pot €1.25 | Rake €0.08 
Board [2c 7h Ts Th 5s]
Seat 1: SebIsGood (big blind) showed [6s Kc] and lost with a pair of Tens
Seat 2: elamigo63 folded before Flop (didn't bet)
Seat 3: Gunt101 folded before Flop (didn't bet)
Seat 4: Sharky-Nadal folded before Flop (didn't bet)
Seat 5: mikrethor (button) showed [Qd Ad] and won (€1.17) with a pair of Tens
Seat 6: DiMiTiA (small blind) folded before Flop



PokerStars Hand #109564219986:  Hold'em No Limit (€0.01/€0.02 EUR) - 2014/01/04 12:46:34 CET [2014/01/04 6:46:34 ET]
Table 'Ambrosia III' 6-max Seat #6 is the button
Seat 1: SebIsGood (€4.94 in chips) 
Seat 2: elamigo63 (€1.50 in chips) 
Seat 3: Gunt101 (€0.62 in chips) 
Seat 4: Sharky-Nadal (€2 in chips) 
Seat 5: mikrethor (€2.52 in chips) 
Seat 6: DiMiTiA (€1.80 in chips) 
SebIsGood: posts small blind €0.01
elamigo63: posts big blind €0.02
*** HOLE CARDS ***
Dealt to mikrethor [9c 7d]
Gunt101: calls €0.02
Sharky-Nadal: folds 
mikrethor: folds 
DiMiTiA: raises €0.02 to €0.04
SebIsGood: raises €0.12 to €0.16
elamigo63: folds 
Gunt101: calls €0.14
DiMiTiA: folds 
*** FLOP *** [Tc 2s 6d]
SebIsGood: bets €0.36
Gunt101: calls €0.36
*** TURN *** [Tc 2s 6d] [Qs]
SebIsGood: bets €1.02
Gunt101: calls €0.10 and is all-in
Uncalled bet (€0.92) returned to SebIsGood
*** RIVER *** [Tc 2s 6d Qs] [Ts]
*** SHOW DOWN ***
SebIsGood: shows [Jd 2h] (two pair, Tens and Deuces)
Gunt101: shows [6c Kh] (two pair, Tens and Sixes)
Gunt101 collected €1.22 from pot
*** SUMMARY ***
Total pot €1.30 | Rake €0.08 
Board [Tc 2s 6d Qs Ts]
Seat 1: SebIsGood (small blind) showed [Jd 2h] and lost with two pair, Tens and Deuces
Seat 2: elamigo63 (big blind) folded before Flop
Seat 3: Gunt101 showed [6c Kh] and won (€1.22) with two pair, Tens and Sixes
Seat 4: Sharky-Nadal folded before Flop (didn't bet)
Seat 5: mikrethor folded before Flop (didn't bet)
Seat 6: DiMiTiA (button) folded before Flop



PokerStars Hand #109564241459:  Hold'em No Limit (€0.01/€0.02 EUR) - 2014/01/04 12:47:13 CET [2014/01/04 6:47:13 ET]
Table 'Ambrosia III' 6-max Seat #1 is the button
Seat 1: SebIsGood (€4.32 in chips) 
Seat 2: elamigo63 (€1.48 in chips) 
Seat 4: Sharky-Nadal (€2 in chips) 
Seat 5: mikrethor (€2.52 in chips) 
Seat 6: DiMiTiA (€1.76 in chips) 
elamigo63: posts small blind €0.01
Sharky-Nadal: posts big blind €0.02
*** HOLE CARDS ***
Dealt to mikrethor [6s 2h]
mikrethor: folds 
DiMiTiA: folds 
SebIsGood: raises €0.15 to €0.17
elamigo63: calls €0.16
Sharky-Nadal: calls €0.15
*** FLOP *** [Js Ad Kc]
elamigo63: checks 
Sharky-Nadal: checks 
SebIsGood: bets €0.48
elamigo63: calls €0.48
Sharky-Nadal: calls €0.48
*** TURN *** [Js Ad Kc] [7c]
elamigo63: bets €0.02
Sharky-Nadal: calls €0.02
SebIsGood: calls €0.02
*** RIVER *** [Js Ad Kc 7c] [Th]
elamigo63: bets €0.02
Sharky-Nadal: calls €0.02
SebIsGood: calls €0.02
*** SHOW DOWN ***
elamigo63: shows [Jh As] (two pair, Aces and Jacks)
Sharky-Nadal: mucks hand 
SebIsGood: mucks hand 
elamigo63 collected €1.95 from pot
*** SUMMARY ***
Total pot €2.07 | Rake €0.12 
Board [Js Ad Kc 7c Th]
Seat 1: SebIsGood (button) mucked [Jc 5s]
Seat 2: elamigo63 (small blind) showed [Jh As] and won (€1.95) with two pair, Aces and Jacks
Seat 4: Sharky-Nadal (big blind) mucked [Td Kd]
Seat 5: mikrethor folded before Flop (didn't bet)
Seat 6: DiMiTiA folded before Flop (didn't bet)



PokerStars Hand #109564271597:  Hold'em No Limit (€0.01/€0.02 EUR) - 2014/01/04 12:48:08 CET [2014/01/04 6:48:08 ET]
Table 'Ambrosia III' 6-max Seat #2 is the button
Seat 1: SebIsGood (€3.63 in chips) 
Seat 2: elamigo63 (€2.74 in chips) 
Seat 4: Sharky-Nadal (€2 in chips) 
Seat 5: mikrethor (€2.52 in chips) 
Seat 6: DiMiTiA (€1.76 in chips) 
Gunt101 will be allowed to play after the button
Sharky-Nadal: posts small blind €0.01
mikrethor: posts big blind €0.02
*** HOLE CARDS ***
Dealt to mikrethor [7h Js]
DiMiTiA: raises €0.02 to €0.04
SebIsGood: raises €0.21 to €0.25
elamigo63: calls €0.25
Sharky-Nadal: folds 
mikrethor: folds 
DiMiTiA: folds 
*** FLOP *** [3d 9c Jd]
Sharky-Nadal leaves the table
SebIsGood: bets €3.38 and is all-in
elamigo63: calls €2.49 and is all-in
Uncalled bet (€0.89) returned to SebIsGood
*** TURN *** [3d 9c Jd] [9s]
*** RIVER *** [3d 9c Jd 9s] [Ac]
*** SHOW DOWN ***
SebIsGood: shows [3h 7s] (two pair, Nines and Threes)
elamigo63: shows [As 7c] (two pair, Aces and Nines)
elamigo63 collected €5.22 from pot
*** SUMMARY ***
Total pot €5.55 | Rake €0.33 
Board [3d 9c Jd 9s Ac]
Seat 1: SebIsGood showed [3h 7s] and lost with two pair, Nines and Threes
Seat 2: elamigo63 (button) showed [As 7c] and won (€5.22) with two pair, Aces and Nines
Seat 4: Sharky-Nadal (small blind) folded before Flop
Seat 5: mikrethor (big blind) folded before Flop
Seat 6: DiMiTiA folded before Flop



PokerStars Hand #109564293642:  Hold'em No Limit (€0.01/€0.02 EUR) - 2014/01/04 12:48:47 CET [2014/01/04 6:48:47 ET]
Table 'Ambrosia III' 6-max Seat #5 is the button
Seat 1: SebIsGood (€0.89 in chips) 
Seat 2: elamigo63 (€5.22 in chips) 
Seat 3: Gunt101 (€1.22 in chips) 
Seat 5: mikrethor (€2.50 in chips) 
Seat 6: DiMiTiA (€1.72 in chips) 
DiMiTiA: posts small blind €0.01
SebIsGood: posts big blind €0.02
Gunt101: posts small & big blinds €0.03
*** HOLE CARDS ***
Dealt to mikrethor [9d 8c]
elamigo63: folds 
Gunt101: checks 
mikrethor: folds 
elamigo63 said, "lol"
DiMiTiA: calls €0.01
SebIsGood: raises €0.87 to €0.89 and is all-in
Gunt101: folds 
DiMiTiA: folds 
Uncalled bet (€0.87) returned to SebIsGood
SebIsGood collected €0.07 from pot
*** SUMMARY ***
Total pot €0.07 | Rake €0 
Seat 1: SebIsGood (big blind) collected (€0.07)
Seat 2: elamigo63 folded before Flop (didn't bet)
Seat 3: Gunt101 folded before Flop
Seat 5: mikrethor (button) folded before Flop (didn't bet)
Seat 6: DiMiTiA (small blind) folded before Flop



PokerStars Hand #109564306938:  Hold'em No Limit (€0.01/€0.02 EUR) - 2014/01/04 12:49:11 CET [2014/01/04 6:49:11 ET]
Table 'Ambrosia III' 6-max Seat #6 is the button
Seat 1: SebIsGood (€0.94 in chips) 
Seat 2: elamigo63 (€5.22 in chips) 
Seat 3: Gunt101 (€1.19 in chips) 
Seat 5: mikrethor (€2.50 in chips) 
Seat 6: DiMiTiA (€1.70 in chips) 
SebIsGood: posts small blind €0.01
elamigo63: posts big blind €0.02
*** HOLE CARDS ***
Dealt to mikrethor [3d Qc]
Gunt101: calls €0.02
mikrethor: folds 
DiMiTiA: folds 
SebIsGood: raises €0.92 to €0.94 and is all-in
2mickey7 joins the table at seat #4 
elamigo63: folds 
Gunt101: calls €0.92
*** FLOP *** [6d As 6s]
*** TURN *** [6d As 6s] [Ks]
*** RIVER *** [6d As 6s Ks] [8h]
*** SHOW DOWN ***
SebIsGood: shows [Jh Kc] (two pair, Kings and Sixes)
Gunt101: mucks hand 
SebIsGood collected €1.79 from pot
*** SUMMARY ***
Total pot €1.90 | Rake €0.11 
Board [6d As 6s Ks 8h]
Seat 1: SebIsGood (small blind) showed [Jh Kc] and won (€1.79) with two pair, Kings and Sixes
Seat 2: elamigo63 (big blind) folded before Flop
Seat 3: Gunt101 mucked [Qh 8s]
Seat 5: mikrethor folded before Flop (didn't bet)
Seat 6: DiMiTiA (button) folded before Flop (didn't bet)



PokerStars Hand #109564318333:  Hold'em No Limit (€0.01/€0.02 EUR) - 2014/01/04 12:49:31 CET [2014/01/04 6:49:31 ET]
Table 'Ambrosia III' 6-max Seat #1 is the button
Seat 1: SebIsGood (€1.79 in chips) 
Seat 2: elamigo63 (€5.20 in chips) 
Seat 3: Gunt101 (€0.25 in chips) 
Seat 5: mikrethor (€2.50 in chips) 
Seat 6: DiMiTiA (€1.70 in chips) 
elamigo63: posts small blind €0.01
Gunt101: posts big blind €0.02
2mickey7: sits out 
*** HOLE CARDS ***
Dealt to mikrethor [9h 4s]
mikrethor: folds 
DiMiTiA: folds 
SebIsGood: raises €1.77 to €1.79 and is all-in
elamigo63: folds 
Gunt101: calls €0.23 and is all-in
Uncalled bet (€1.54) returned to SebIsGood
*** FLOP *** [5s 8c Td]
*** TURN *** [5s 8c Td] [9c]
*** RIVER *** [5s 8c Td 9c] [5d]
*** SHOW DOWN ***
Gunt101: shows [Tc Jd] (two pair, Tens and Fives)
SebIsGood: shows [5c Qd] (three of a kind, Fives)
SebIsGood collected €0.48 from pot
*** SUMMARY ***
Total pot €0.51 | Rake €0.03 
Board [5s 8c Td 9c 5d]
Seat 1: SebIsGood (button) showed [5c Qd] and won (€0.48) with three of a kind, Fives
Seat 2: elamigo63 (small blind) folded before Flop
Seat 3: Gunt101 (big blind) showed [Tc Jd] and lost with two pair, Tens and Fives
Seat 5: mikrethor folded before Flop (didn't bet)
Seat 6: DiMiTiA folded before Flop (didn't bet)



PokerStars Hand #109564327816:  Hold'em No Limit (€0.01/€0.02 EUR) - 2014/01/04 12:49:48 CET [2014/01/04 6:49:48 ET]
Table 'Ambrosia III' 6-max Seat #2 is the button
Seat 1: SebIsGood (€2.02 in chips) 
Seat 2: elamigo63 (€5.19 in chips) 
Seat 5: mikrethor (€2.50 in chips) 
Seat 6: DiMiTiA (€1.70 in chips) 
2mickey7 will be allowed to play after the button
mikrethor: posts small blind €0.01
DiMiTiA: posts big blind €0.02
*** HOLE CARDS ***
Dealt to mikrethor [2s Kh]
SebIsGood: raises €2 to €2.02 and is all-in
elamigo63: folds 
mikrethor: folds 
DiMiTiA: folds 
Uncalled bet (€2) returned to SebIsGood
SebIsGood collected €0.05 from pot
*** SUMMARY ***
Total pot €0.05 | Rake €0 
Seat 1: SebIsGood collected (€0.05)
Seat 2: elamigo63 (button) folded before Flop (didn't bet)
Seat 5: mikrethor (small blind) folded before Flop
Seat 6: DiMiTiA (big blind) folded before Flop



PokerStars Hand #109564332738:  Hold'em No Limit (€0.01/€0.02 EUR) - 2014/01/04 12:49:57 CET [2014/01/04 6:49:57 ET]
Table 'Ambrosia III' 6-max Seat #5 is the button
Seat 1: SebIsGood (€2.05 in chips) 
Seat 2: elamigo63 (€5.19 in chips) 
Seat 5: mikrethor (€2.49 in chips) 
Seat 6: DiMiTiA (€1.68 in chips) 
DiMiTiA: posts small blind €0.01
SebIsGood: posts big blind €0.02
Gunt101 leaves the table
2mickey7: sits out 
*** HOLE CARDS ***
Dealt to mikrethor [7d 8d]
elamigo63: folds 
mikrethor: folds 
DiMiTiA: folds 
Uncalled bet (€0.01) returned to SebIsGood
SebIsGood collected €0.02 from pot
*** SUMMARY ***
Total pot €0.02 | Rake €0 
Seat 1: SebIsGood (big blind) collected (€0.02)
Seat 2: elamigo63 folded before Flop (didn't bet)
Seat 5: mikrethor (button) folded before Flop (didn't bet)
Seat 6: DiMiTiA (small blind) folded before Flop



PokerStars Hand #109564338077:  Hold'em No Limit (€0.01/€0.02 EUR) - 2014/01/04 12:50:07 CET [2014/01/04 6:50:07 ET]
Table 'Ambrosia III' 6-max Seat #6 is the button
Seat 1: SebIsGood (€2.06 in chips) 
Seat 2: elamigo63 (€5.19 in chips) 
Seat 5: mikrethor (€2.49 in chips) 
Seat 6: DiMiTiA (€1.67 in chips) 
SebIsGood: posts small blind €0.01
elamigo63: posts big blind €0.02
2mickey7: sits out 
*** HOLE CARDS ***
Dealt to mikrethor [7h Jc]
mikrethor: folds 
DiMiTiA: folds 
SebIsGood: raises €2.04 to €2.06 and is all-in
elamigo63: folds 
Uncalled bet (€2.04) returned to SebIsGood
SebIsGood collected €0.04 from pot
*** SUMMARY ***
Total pot €0.04 | Rake €0 
Seat 1: SebIsGood (small blind) collected (€0.04)
Seat 2: elamigo63 (big blind) folded before Flop
Seat 5: mikrethor folded before Flop (didn't bet)
Seat 6: DiMiTiA (button) folded before Flop (didn't bet)



PokerStars Hand #109564343040:  Hold'em No Limit (€0.01/€0.02 EUR) - 2014/01/04 12:50:16 CET [2014/01/04 6:50:16 ET]
Table 'Ambrosia III' 6-max Seat #1 is the button
Seat 1: SebIsGood (€2.08 in chips) 
Seat 2: elamigo63 (€5.17 in chips) 
Seat 4: 2mickey7 (€2 in chips) 
Seat 5: mikrethor (€2.49 in chips) 
Seat 6: DiMiTiA (€1.67 in chips) 
elamigo63: posts small blind €0.01
2mickey7: posts big blind €0.02
*** HOLE CARDS ***
Dealt to mikrethor [As 6h]
mikrethor: folds 
DiMiTiA: folds 
SebIsGood: calls €0.02
elamigo63: calls €0.01
2mickey7: checks 
*** FLOP *** [Jc 7c 6s]
elamigo63: checks 
2mickey7: checks 
SebIsGood: bets €0.06
elamigo63: calls €0.06
2mickey7: calls €0.06
*** TURN *** [Jc 7c 6s] [Jh]
elamigo63: checks 
2mickey7: checks 
SebIsGood: bets €0.22
elamigo63: raises €0.22 to €0.44
2mickey7: folds 
SebIsGood: calls €0.22
*** RIVER *** [Jc 7c 6s Jh] [Kc]
elamigo63: checks 
SebIsGood: bets €1.56 and is all-in
elamigo63: calls €1.56
*** SHOW DOWN ***
SebIsGood: shows [6c 4h] (two pair, Jacks and Sixes)
elamigo63: shows [7h Ac] (two pair, Jacks and Sevens)
elamigo63 collected €3.99 from pot
*** SUMMARY ***
Total pot €4.24 | Rake €0.25 
Board [Jc 7c 6s Jh Kc]
Seat 1: SebIsGood (button) showed [6c 4h] and lost with two pair, Jacks and Sixes
Seat 2: elamigo63 (small blind) showed [7h Ac] and won (€3.99) with two pair, Jacks and Sevens
Seat 4: 2mickey7 (big blind) folded on the Turn
Seat 5: mikrethor folded before Flop (didn't bet)
Seat 6: DiMiTiA folded before Flop (didn't bet)



PokerStars Hand #109564377857:  Hold'em No Limit (€0.01/€0.02 EUR) - 2014/01/04 12:51:18 CET [2014/01/04 6:51:18 ET]
Table 'Ambrosia III' 6-max Seat #2 is the button
Seat 2: elamigo63 (€7.08 in chips) 
Seat 4: 2mickey7 (€1.92 in chips) 
Seat 5: mikrethor (€2.49 in chips) 
Seat 6: DiMiTiA (€1.67 in chips) 
2mickey7: posts small blind €0.01
mikrethor: posts big blind €0.02
*** HOLE CARDS ***
Dealt to mikrethor [As 6h]
DiMiTiA: folds 
elamigo63: folds 
2mickey7: calls €0.01
SebIsGood leaves the table
mikrethor: raises €0.06 to €0.08
2mickey7: calls €0.06
*** FLOP *** [2d Kd Jh]
2mickey7: checks 
mikrethor: checks 
*** TURN *** [2d Kd Jh] [5d]
2mickey7: bets €0.08
mikrethor: folds 
Uncalled bet (€0.08) returned to 2mickey7
2mickey7 collected €0.15 from pot
2mickey7: doesn't show hand 
*** SUMMARY ***
Total pot €0.16 | Rake €0.01 
Board [2d Kd Jh 5d]
Seat 2: elamigo63 (button) folded before Flop (didn't bet)
Seat 4: 2mickey7 (small blind) collected (€0.15)
Seat 5: mikrethor (big blind) folded on the Turn
Seat 6: DiMiTiA folded before Flop (didn't bet)



PokerStars Hand #109564403277:  Hold'em No Limit (€0.01/€0.02 EUR) - 2014/01/04 12:52:04 CET [2014/01/04 6:52:04 ET]
Table 'Ambrosia III' 6-max Seat #4 is the button
Seat 2: elamigo63 (€7.08 in chips) 
Seat 4: 2mickey7 (€1.99 in chips) 
Seat 5: mikrethor (€2.41 in chips) 
Seat 6: DiMiTiA (€1.67 in chips) 
mikrethor: posts small blind €0.01
DiMiTiA: posts big blind €0.02
*** HOLE CARDS ***
Dealt to mikrethor [Qc 2s]
elamigo63: folds 
2mickey7: calls €0.02
mikrethor: folds 
DiMiTiA: checks 
*** FLOP *** [7h Kh 9c]
DiMiTiA: bets €0.04
2mickey7: calls €0.04
*** TURN *** [7h Kh 9c] [Ks]
DiMiTiA: bets €0.06
2mickey7: calls €0.06
*** RIVER *** [7h Kh 9c Ks] [2d]
eastwood009 joins the table at seat #1 
DiMiTiA: checks 
2mickey7: checks 
*** SHOW DOWN ***
DiMiTiA: shows [7c 5c] (two pair, Kings and Sevens)
2mickey7: mucks hand 
DiMiTiA collected €0.23 from pot
*** SUMMARY ***
Total pot €0.25 | Rake €0.02 
Board [7h Kh 9c Ks 2d]
Seat 2: elamigo63 folded before Flop (didn't bet)
Seat 4: 2mickey7 (button) mucked [8h Js]
Seat 5: mikrethor (small blind) folded before Flop
Seat 6: DiMiTiA (big blind) showed [7c 5c] and won (€0.23) with two pair, Kings and Sevens



PokerStars Hand #109564432050:  Hold'em No Limit (€0.01/€0.02 EUR) - 2014/01/04 12:52:56 CET [2014/01/04 6:52:56 ET]
Table 'Ambrosia III' 6-max Seat #5 is the button
Seat 1: eastwood009 (€1 in chips) 
Seat 2: elamigo63 (€7.08 in chips) 
Seat 4: 2mickey7 (€1.87 in chips) 
Seat 5: mikrethor (€2.40 in chips) 
Seat 6: DiMiTiA (€1.78 in chips) 
DiMiTiA: posts small blind €0.01
eastwood009: posts big blind €0.02
*** HOLE CARDS ***
Dealt to mikrethor [9c 6s]
elamigo63: calls €0.02
2mickey7: calls €0.02
mikrethor: folds 
DiMiTiA: folds 
eastwood009: checks 
*** FLOP *** [2h 4s 4h]
eastwood009: checks 
elamigo63: bets €0.02
2mickey7: folds 
eastwood009: folds 
Uncalled bet (€0.02) returned to elamigo63
2mickey7 leaves the table
elamigo63 collected €0.07 from pot
*** SUMMARY ***
Total pot €0.07 | Rake €0 
Board [2h 4s 4h]
Seat 1: eastwood009 (big blind) folded on the Flop
Seat 2: elamigo63 collected (€0.07)
Seat 4: 2mickey7 folded on the Flop
Seat 5: mikrethor (button) folded before Flop (didn't bet)
Seat 6: DiMiTiA (small blind) folded before Flop



PokerStars Hand #109564449603:  Hold'em No Limit (€0.01/€0.02 EUR) - 2014/01/04 12:53:27 CET [2014/01/04 6:53:27 ET]
Table 'Ambrosia III' 6-max Seat #6 is the button
Seat 1: eastwood009 (€0.98 in chips) 
Seat 5: mikrethor (€2.40 in chips) 
Seat 6: DiMiTiA (€1.77 in chips) 
eastwood009: posts small blind €0.01
elamigo63: is sitting out 
mikrethor: posts big blind €0.02
*** HOLE CARDS ***
Dealt to mikrethor [Tc Kh]
DiMiTiA: raises €0.02 to €0.04
rapace34 joins the table at seat #3 
eastwood009: folds 
mikrethor: calls €0.02
*** FLOP *** [7d Th 6c]
elamigo63 leaves the table
mikrethor: checks 
DiMiTiA: bets €0.06
mikrethor: calls €0.06
*** TURN *** [7d Th 6c] [2d]
mikrethor: checks 
DiMiTiA: bets €0.12
mikrethor: calls €0.12
*** RIVER *** [7d Th 6c 2d] [Kd]
mikrethor: bets €0.42
DiMiTiA: folds 
Uncalled bet (€0.42) returned to mikrethor
mikrethor collected €0.42 from pot
mikrethor: doesn't show hand 
*** SUMMARY ***
Total pot €0.45 | Rake €0.03 
Board [7d Th 6c 2d Kd]
Seat 1: eastwood009 (small blind) folded before Flop
Seat 5: mikrethor (big blind) collected (€0.42)
Seat 6: DiMiTiA (button) folded on the River



PokerStars Hand #109564470782:  Hold'em No Limit (€0.01/€0.02 EUR) - 2014/01/04 12:54:05 CET [2014/01/04 6:54:05 ET]
Table 'Ambrosia III' 6-max Seat #1 is the button
Seat 1: eastwood009 (€0.97 in chips) 
Seat 5: mikrethor (€2.60 in chips) 
Seat 6: DiMiTiA (€1.55 in chips) 
rapace34 will be allowed to play after the button
mikrethor: posts small blind €0.01
DiMiTiA: posts big blind €0.02
*** HOLE CARDS ***
Dealt to mikrethor [8d Qc]
eastwood009: calls €0.02
mikrethor: folds 
DiMiTiA: raises €0.02 to €0.04
eastwood009: calls €0.02
*** FLOP *** [4d Qh Kd]
DiMiTiA: bets €0.06
eastwood009: calls €0.06
*** TURN *** [4d Qh Kd] [3s]
DiMiTiA: bets €0.14
eastwood009: calls €0.14
*** RIVER *** [4d Qh Kd 3s] [7s]
DiMiTiA: bets €0.28
eastwood009: folds 
Uncalled bet (€0.28) returned to DiMiTiA
DiMiTiA collected €0.46 from pot
*** SUMMARY ***
Total pot €0.49 | Rake €0.03 
Board [4d Qh Kd 3s 7s]
Seat 1: eastwood009 (button) folded on the River
Seat 5: mikrethor (small blind) folded before Flop
Seat 6: DiMiTiA (big blind) collected (€0.46)



PokerStars Hand #109564495515:  Hold'em No Limit (€0.01/€0.02 EUR) - 2014/01/04 12:54:49 CET [2014/01/04 6:54:49 ET]
Table 'Ambrosia III' 6-max Seat #5 is the button
Seat 1: eastwood009 (€0.73 in chips) 
Seat 3: rapace34 (€1.60 in chips) 
Seat 5: mikrethor (€2.59 in chips) 
Seat 6: DiMiTiA (€1.77 in chips) 
DiMiTiA: posts small blind €0.01
eastwood009: posts big blind €0.02
rapace34: posts big blind €0.02
*** HOLE CARDS ***
Dealt to mikrethor [6s 6h]
rapace34: checks 
mikrethor: raises €0.06 to €0.08
DiMiTiA: raises €0.06 to €0.14
eastwood009: folds 
rapace34: calls €0.12
mikrethor: calls €0.06
*** FLOP *** [Js 5c 2c]
DiMiTiA: bets €0.20
rapace34: calls €0.20
mikrethor: folds 
*** TURN *** [Js 5c 2c] [3h]
thierryjc11 joins the table at seat #2 
DiMiTiA: checks 
rapace34: bets €0.32
DiMiTiA: calls €0.32
*** RIVER *** [Js 5c 2c 3h] [4d]
DiMiTiA: checks 
rapace34: bets €0.94 and is all-in
MisterNice95 joins the table at seat #4 
DiMiTiA: folds 
Uncalled bet (€0.94) returned to rapace34
rapace34 collected €1.39 from pot
*** SUMMARY ***
Total pot €1.48 | Rake €0.09 
Board [Js 5c 2c 3h 4d]
Seat 1: eastwood009 (big blind) folded before Flop
Seat 3: rapace34 collected (€1.39)
Seat 5: mikrethor (button) folded on the Flop
Seat 6: DiMiTiA (small blind) folded on the River



PokerStars Hand #109564530617:  Hold'em No Limit (€0.01/€0.02 EUR) - 2014/01/04 12:56:04 CET [2014/01/04 6:56:04 ET]
Table 'Ambrosia III' 6-max Seat #6 is the button
Seat 1: eastwood009 (€0.71 in chips) 
Seat 2: thierryjc11 (€1 in chips) 
Seat 3: rapace34 (€2.33 in chips) 
Seat 5: mikrethor (€2.45 in chips) 
Seat 6: DiMiTiA (€1.11 in chips) 
eastwood009: posts small blind €0.01
thierryjc11: posts big blind €0.02
MisterNice95: sits out 
*** HOLE CARDS ***
Dealt to mikrethor [Ts Qs]
rapace34: calls €0.02
mikrethor: calls €0.02
DiMiTiA: raises €0.06 to €0.08
eastwood009: folds 
thierryjc11: folds 
rapace34: folds 
mikrethor: calls €0.06
*** FLOP *** [2s Kh 7h]
mikrethor: checks 
DiMiTiA: bets €0.12
mikrethor: folds 
Uncalled bet (€0.12) returned to DiMiTiA
DiMiTiA collected €0.20 from pot
*** SUMMARY ***
Total pot €0.21 | Rake €0.01 
Board [2s Kh 7h]
Seat 1: eastwood009 (small blind) folded before Flop
Seat 2: thierryjc11 (big blind) folded before Flop
Seat 3: rapace34 folded before Flop
Seat 5: mikrethor folded on the Flop
Seat 6: DiMiTiA (button) collected (€0.20)



PokerStars Hand #109564545844:  Hold'em No Limit (€0.01/€0.02 EUR) - 2014/01/04 12:56:38 CET [2014/01/04 6:56:38 ET]
Table 'Ambrosia III' 6-max Seat #1 is the button
Seat 1: eastwood009 (€0.70 in chips) 
Seat 2: thierryjc11 (€0.98 in chips) 
Seat 3: rapace34 (€2.31 in chips) 
Seat 4: MisterNice95 (€1 in chips) 
Seat 5: mikrethor (€2.37 in chips) 
Seat 6: DiMiTiA (€1.23 in chips) 
thierryjc11: posts small blind €0.01
rapace34: posts big blind €0.02
MisterNice95: posts big blind €0.02
*** HOLE CARDS ***
Dealt to mikrethor [Ah 4s]
MisterNice95: checks 
mikrethor: folds 
DiMiTiA: raises €0.02 to €0.04
eastwood009: folds 
thierryjc11: calls €0.03
rapace34: calls €0.02
MisterNice95: calls €0.02
*** FLOP *** [7s 7c Ts]
thierryjc11: checks 
rapace34: checks 
MisterNice95: checks 
DiMiTiA: bets €0.10
thierryjc11: folds 
rapace34: folds 
MisterNice95: folds 
Uncalled bet (€0.10) returned to DiMiTiA
DiMiTiA collected €0.15 from pot
*** SUMMARY ***
Total pot €0.16 | Rake €0.01 
Board [7s 7c Ts]
Seat 1: eastwood009 (button) folded before Flop (didn't bet)
Seat 2: thierryjc11 (small blind) folded on the Flop
Seat 3: rapace34 (big blind) folded on the Flop
Seat 4: MisterNice95 folded on the Flop
Seat 5: mikrethor folded before Flop (didn't bet)
Seat 6: DiMiTiA collected (€0.15)



PokerStars Hand #109564572820:  Hold'em No Limit (€0.01/€0.02 EUR) - 2014/01/04 12:57:38 CET [2014/01/04 6:57:38 ET]
Table 'Ambrosia III' 6-max Seat #2 is the button
Seat 1: eastwood009 (€0.70 in chips) 
Seat 2: thierryjc11 (€0.94 in chips) 
Seat 3: rapace34 (€2.27 in chips) 
Seat 4: MisterNice95 (€0.96 in chips) 
Seat 5: mikrethor (€2.37 in chips) 
Seat 6: DiMiTiA (€1.34 in chips) 
rapace34: posts small blind €0.01
MisterNice95: posts big blind €0.02
*** HOLE CARDS ***
Dealt to mikrethor [9c 8d]
mikrethor: folds 
DiMiTiA: raises €0.02 to €0.04
eastwood009: calls €0.04
thierryjc11: folds 
rapace34: calls €0.03
MisterNice95: calls €0.02
*** FLOP *** [9d 6h 9h]
rapace34: bets €0.02
MisterNice95: calls €0.02
DiMiTiA: folds 
eastwood009: folds 
*** TURN *** [9d 6h 9h] [5d]
rapace34: bets €0.12
MisterNice95: folds 
Uncalled bet (€0.12) returned to rapace34
rapace34 collected €0.19 from pot
rapace34: doesn't show hand 
*** SUMMARY ***
Total pot €0.20 | Rake €0.01 
Board [9d 6h 9h 5d]
Seat 1: eastwood009 folded on the Flop
Seat 2: thierryjc11 (button) folded before Flop (didn't bet)
Seat 3: rapace34 (small blind) collected (€0.19)
Seat 4: MisterNice95 (big blind) folded on the Turn
Seat 5: mikrethor folded before Flop (didn't bet)
Seat 6: DiMiTiA folded on the Flop



PokerStars Hand #109564593097:  Hold'em No Limit (€0.01/€0.02 EUR) - 2014/01/04 12:58:22 CET [2014/01/04 6:58:22 ET]
Table 'Ambrosia III' 6-max Seat #3 is the button
Seat 1: eastwood009 (€0.66 in chips) 
Seat 2: thierryjc11 (€0.94 in chips) 
Seat 3: rapace34 (€2.40 in chips) 
Seat 4: MisterNice95 (€0.90 in chips) 
Seat 5: mikrethor (€2.37 in chips) 
Seat 6: DiMiTiA (€1.30 in chips) 
MisterNice95: posts small blind €0.01
mikrethor: posts big blind €0.02
*** HOLE CARDS ***
Dealt to mikrethor [3c Kc]
DiMiTiA: raises €0.04 to €0.06
eastwood009: folds 
thierryjc11: calls €0.06
rapace34: folds 
MisterNice95: calls €0.05
mikrethor: calls €0.04
*** FLOP *** [7c 8h 9s]
MisterNice95: checks 
mikrethor: checks 
DiMiTiA: bets €0.10
thierryjc11: folds 
MisterNice95: calls €0.10
mikrethor: folds 
*** TURN *** [7c 8h 9s] [2s]
MisterNice95: checks 
DiMiTiA: checks 
*** RIVER *** [7c 8h 9s 2s] [Ts]
MisterNice95: bets €0.10
DiMiTiA: calls €0.10
*** SHOW DOWN ***
MisterNice95: shows [Jh Th] (a straight, Seven to Jack)
DiMiTiA: mucks hand 
MisterNice95 collected €0.60 from pot
*** SUMMARY ***
Total pot €0.64 | Rake €0.04 
Board [7c 8h 9s 2s Ts]
Seat 1: eastwood009 folded before Flop (didn't bet)
Seat 2: thierryjc11 folded on the Flop
Seat 3: rapace34 (button) folded before Flop (didn't bet)
Seat 4: MisterNice95 (small blind) showed [Jh Th] and won (€0.60) with a straight, Seven to Jack
Seat 5: mikrethor (big blind) folded on the Flop
Seat 6: DiMiTiA mucked [6s Ac]



PokerStars Hand #109564623375:  Hold'em No Limit (€0.01/€0.02 EUR) - 2014/01/04 12:59:29 CET [2014/01/04 6:59:29 ET]
Table 'Ambrosia III' 6-max Seat #4 is the button
Seat 1: eastwood009 (€0.66 in chips) 
Seat 2: thierryjc11 (€0.88 in chips) 
Seat 3: rapace34 (€2.40 in chips) 
Seat 4: MisterNice95 (€1.24 in chips) 
Seat 5: mikrethor (€2.31 in chips) 
Seat 6: DiMiTiA (€1.04 in chips) 
mikrethor: posts small blind €0.01
DiMiTiA: posts big blind €0.02
*** HOLE CARDS ***
Dealt to mikrethor [Ah 9d]
eastwood009: folds 
thierryjc11: calls €0.02
rapace34: calls €0.02
MisterNice95: calls €0.02
mikrethor: calls €0.01
DiMiTiA: checks 
*** FLOP *** [3d Jd 3s]
mikrethor: checks 
DiMiTiA: checks 
thierryjc11: bets €0.02
rapace34: raises €0.02 to €0.04
MisterNice95: folds 
mikrethor: folds 
DiMiTiA: folds 
thierryjc11: calls €0.02
*** TURN *** [3d Jd 3s] [3c]
thierryjc11: checks 
rapace34: checks 
*** RIVER *** [3d Jd 3s 3c] [8h]
thierryjc11: bets €0.06
rapace34: folds 
Uncalled bet (€0.06) returned to thierryjc11
thierryjc11 collected €0.17 from pot
thierryjc11: doesn't show hand 
*** SUMMARY ***
Total pot €0.18 | Rake €0.01 
Board [3d Jd 3s 3c 8h]
Seat 1: eastwood009 folded before Flop (didn't bet)
Seat 2: thierryjc11 collected (€0.17)
Seat 3: rapace34 folded on the River
Seat 4: MisterNice95 (button) folded on the Flop
Seat 5: mikrethor (small blind) folded on the Flop
Seat 6: DiMiTiA (big blind) folded on the Flop



PokerStars Hand #109564652505:  Hold'em No Limit (€0.01/€0.02 EUR) - 2014/01/04 13:00:31 CET [2014/01/04 7:00:31 ET]
Table 'Ambrosia III' 6-max Seat #5 is the button
Seat 2: thierryjc11 (€0.99 in chips) 
Seat 3: rapace34 (€2.34 in chips) 
Seat 4: MisterNice95 (€1.22 in chips) 
Seat 5: mikrethor (€2.29 in chips) 
Seat 6: DiMiTiA (€1.02 in chips) 
DiMiTiA: posts small blind €0.01
thierryjc11: posts big blind €0.02
*** HOLE CARDS ***
Dealt to mikrethor [4d 2c]
rapace34: calls €0.02
MisterNice95: calls €0.02
mikrethor: folds 
DiMiTiA: calls €0.01
thierryjc11: checks 
*** FLOP *** [3h Ks 3s]
DiMiTiA: bets €0.04
thierryjc11: folds 
rapace34: folds 
MisterNice95: folds 
Uncalled bet (€0.04) returned to DiMiTiA
DiMiTiA collected €0.08 from pot
*** SUMMARY ***
Total pot €0.08 | Rake €0 
Board [3h Ks 3s]
Seat 2: thierryjc11 (big blind) folded on the Flop
Seat 3: rapace34 folded on the Flop
Seat 4: MisterNice95 folded on the Flop
Seat 5: mikrethor (button) folded before Flop (didn't bet)
Seat 6: DiMiTiA (small blind) collected (€0.08)



PokerStars Hand #109564674099:  Hold'em No Limit (€0.01/€0.02 EUR) - 2014/01/04 13:01:13 CET [2014/01/04 7:01:13 ET]
Table 'Ambrosia III' 6-max Seat #6 is the button
Seat 2: thierryjc11 (€0.97 in chips) 
Seat 3: rapace34 (€2.32 in chips) 
Seat 4: MisterNice95 (€1.20 in chips) 
Seat 5: mikrethor (€2.29 in chips) 
Seat 6: DiMiTiA (€1.08 in chips) 
thierryjc11: posts small blind €0.01
rapace34: posts big blind €0.02
*** HOLE CARDS ***
Dealt to mikrethor [9d Ts]
MisterNice95: calls €0.02
mikrethor: calls €0.02
DiMiTiA: folds 
thierryjc11: calls €0.01
rapace34: checks 
*** FLOP *** [4s Jh 8d]
thierryjc11: bets €0.02
rapace34: folds 
MisterNice95: folds 
mikrethor: raises €0.06 to €0.08
thierryjc11: folds 
Uncalled bet (€0.06) returned to mikrethor
mikrethor collected €0.11 from pot
mikrethor: doesn't show hand 
*** SUMMARY ***
Total pot €0.12 | Rake €0.01 
Board [4s Jh 8d]
Seat 2: thierryjc11 (small blind) folded on the Flop
Seat 3: rapace34 (big blind) folded on the Flop
Seat 4: MisterNice95 folded on the Flop
Seat 5: mikrethor collected (€0.11)
Seat 6: DiMiTiA (button) folded before Flop (didn't bet)



PokerStars Hand #109564695935:  Hold'em No Limit (€0.01/€0.02 EUR) - 2014/01/04 13:01:54 CET [2014/01/04 7:01:54 ET]
Table 'Ambrosia III' 6-max Seat #2 is the button
Seat 2: thierryjc11 (€0.93 in chips) 
Seat 3: rapace34 (€2.30 in chips) 
Seat 4: MisterNice95 (€1.18 in chips) 
Seat 5: mikrethor (€2.36 in chips) 
Seat 6: DiMiTiA (€1.08 in chips) 
rapace34: posts small blind €0.01
MisterNice95: posts big blind €0.02
*** HOLE CARDS ***
Dealt to mikrethor [4d 6d]
mikrethor: folds 
DiMiTiA: folds 
thierryjc11: calls €0.02
rapace34: calls €0.01
MisterNice95: checks 
*** FLOP *** [3d Jc Qd]
rapace34: bets €0.02
MisterNice95: folds 
thierryjc11: calls €0.02
*** TURN *** [3d Jc Qd] [4c]
rapace34: bets €0.02
thierryjc11: calls €0.02
*** RIVER *** [3d Jc Qd 4c] [Js]
rapace34: bets €0.26
thierryjc11: folds 
Uncalled bet (€0.26) returned to rapace34
rapace34 collected €0.13 from pot
rapace34: doesn't show hand 
*** SUMMARY ***
Total pot €0.14 | Rake €0.01 
Board [3d Jc Qd 4c Js]
Seat 2: thierryjc11 (button) folded on the River
Seat 3: rapace34 (small blind) collected (€0.13)
Seat 4: MisterNice95 (big blind) folded on the Flop
Seat 5: mikrethor folded before Flop (didn't bet)
Seat 6: DiMiTiA folded before Flop (didn't bet)



PokerStars Hand #109564721725:  Hold'em No Limit (€0.01/€0.02 EUR) - 2014/01/04 13:02:40 CET [2014/01/04 7:02:40 ET]
Table 'Ambrosia III' 6-max Seat #3 is the button
Seat 2: thierryjc11 (€0.87 in chips) 
Seat 3: rapace34 (€2.37 in chips) 
Seat 4: MisterNice95 (€1.16 in chips) 
Seat 5: mikrethor (€2.36 in chips) 
Seat 6: DiMiTiA (€1.08 in chips) 
MisterNice95: posts small blind €0.01
mikrethor: posts big blind €0.02
*** HOLE CARDS ***
Dealt to mikrethor [6h 4h]
DiMiTiA: folds 
thierryjc11: folds 
rapace34: folds 
MisterNice95: folds 
Uncalled bet (€0.01) returned to mikrethor
mikrethor collected €0.02 from pot
mikrethor: doesn't show hand 
*** SUMMARY ***
Total pot €0.02 | Rake €0 
Seat 2: thierryjc11 folded before Flop (didn't bet)
Seat 3: rapace34 (button) folded before Flop (didn't bet)
Seat 4: MisterNice95 (small blind) folded before Flop
Seat 5: mikrethor (big blind) collected (€0.02)
Seat 6: DiMiTiA folded before Flop (didn't bet)



PokerStars Hand #109564734286:  Hold'em No Limit (€0.01/€0.02 EUR) - 2014/01/04 13:03:03 CET [2014/01/04 7:03:03 ET]
Table 'Ambrosia III' 6-max Seat #4 is the button
Seat 2: thierryjc11 (€0.87 in chips) 
Seat 3: rapace34 (€2.37 in chips) 
Seat 4: MisterNice95 (€1.15 in chips) 
Seat 5: mikrethor (€2.37 in chips) 
Seat 6: DiMiTiA (€1.08 in chips) 
mikrethor: posts small blind €0.01
DiMiTiA: posts big blind €0.02
*** HOLE CARDS ***
Dealt to mikrethor [2c 3c]
thierryjc11: calls €0.02
rapace34: calls €0.02
MisterNice95: calls €0.02
mikrethor: calls €0.01
DiMiTiA: raises €0.06 to €0.08
thierryjc11: calls €0.06
rapace34: calls €0.06
MisterNice95: calls €0.06
mikrethor: folds 
*** FLOP *** [5h 4s 9d]
DiMiTiA: bets €0.12
thierryjc11: calls €0.12
rapace34: calls €0.12
MisterNice95: folds 
*** TURN *** [5h 4s 9d] [7s]
DiMiTiA: bets €0.28
thierryjc11: folds 
rapace34: calls €0.28
*** RIVER *** [5h 4s 9d 7s] [Td]
DiMiTiA: checks 
rapace34: bets €0.60
DiMiTiA: folds 
Uncalled bet (€0.60) returned to rapace34
rapace34 collected €1.18 from pot
rapace34: doesn't show hand 
*** SUMMARY ***
Total pot €1.26 | Rake €0.08 
Board [5h 4s 9d 7s Td]
Seat 2: thierryjc11 folded on the Turn
Seat 3: rapace34 collected (€1.18)
Seat 4: MisterNice95 (button) folded on the Flop
Seat 5: mikrethor (small blind) folded before Flop
Seat 6: DiMiTiA (big blind) folded on the River



PokerStars Hand #109564783295:  Hold'em No Limit (€0.01/€0.02 EUR) - 2014/01/04 13:04:28 CET [2014/01/04 7:04:28 ET]
Table 'Ambrosia III' 6-max Seat #5 is the button
Seat 2: thierryjc11 (€0.67 in chips) 
Seat 3: rapace34 (€3.07 in chips) 
Seat 4: MisterNice95 (€1.07 in chips) 
Seat 5: mikrethor (€2.35 in chips) 
Seat 6: DiMiTiA (€0.60 in chips) 
DiMiTiA: posts small blind €0.01
thierryjc11: posts big blind €0.02
*** HOLE CARDS ***
Dealt to mikrethor [5c As]
rapace34: calls €0.02
MisterNice95: folds 
mikrethor: folds 
DiMiTiA: folds 
thierryjc11: checks 
*** FLOP *** [4h Kd 4c]
thierryjc11: bets €0.04
rapace34: folds 
Uncalled bet (€0.04) returned to thierryjc11
thierryjc11 collected €0.05 from pot
thierryjc11: doesn't show hand 
*** SUMMARY ***
Total pot €0.05 | Rake €0 
Board [4h Kd 4c]
Seat 2: thierryjc11 (big blind) collected (€0.05)
Seat 3: rapace34 folded on the Flop
Seat 4: MisterNice95 folded before Flop (didn't bet)
Seat 5: mikrethor (button) folded before Flop (didn't bet)
Seat 6: DiMiTiA (small blind) folded before Flop



PokerStars Hand #109564801937:  Hold'em No Limit (€0.01/€0.02 EUR) - 2014/01/04 13:05:00 CET [2014/01/04 7:05:00 ET]
Table 'Ambrosia III' 6-max Seat #6 is the button
Seat 2: thierryjc11 (€0.70 in chips) 
Seat 3: rapace34 (€3.05 in chips) 
Seat 4: MisterNice95 (€1.07 in chips) 
Seat 5: mikrethor (€2.35 in chips) 
Seat 6: DiMiTiA (€0.59 in chips) 
thierryjc11: posts small blind €0.01
rapace34: posts big blind €0.02
*** HOLE CARDS ***
Dealt to mikrethor [Kc Ad]
MisterNice95: calls €0.02
mikrethor: raises €0.07 to €0.09
DiMiTiA: folds 
thierryjc11: folds 
rapace34: folds 
MisterNice95: folds 
Uncalled bet (€0.07) returned to mikrethor
rapace34 leaves the table
mikrethor collected €0.07 from pot
mikrethor: doesn't show hand 
*** SUMMARY ***
Total pot €0.07 | Rake €0 
Seat 2: thierryjc11 (small blind) folded before Flop
Seat 3: rapace34 (big blind) folded before Flop
Seat 4: MisterNice95 folded before Flop
Seat 5: mikrethor collected (€0.07)
Seat 6: DiMiTiA (button) folded before Flop (didn't bet)



PokerStars Hand #109564822175:  Hold'em No Limit (€0.01/€0.02 EUR) - 2014/01/04 13:05:35 CET [2014/01/04 7:05:35 ET]
Table 'Ambrosia III' 6-max Seat #2 is the button
Seat 2: thierryjc11 (€0.69 in chips) 
Seat 4: MisterNice95 (€1.05 in chips) 
Seat 5: mikrethor (€2.40 in chips) 
Seat 6: DiMiTiA (€0.59 in chips) 
MisterNice95: posts small blind €0.01
mikrethor: posts big blind €0.02
*** HOLE CARDS ***
Dealt to mikrethor [Kd Jd]
chaim33 joins the table at seat #3 
DiMiTiA: folds 
thierryjc11: calls €0.02
MisterNice95: calls €0.01
eastwood009 leaves the table
mikrethor: checks 
*** FLOP *** [Ts 6d 3c]
MisterNice95: bets €0.04
mikrethor: folds 
thierryjc11: calls €0.04
*** TURN *** [Ts 6d 3c] [5d]
MisterNice95: bets €0.06
thierryjc11: folds 
Uncalled bet (€0.06) returned to MisterNice95
MisterNice95 collected €0.13 from pot
MisterNice95: doesn't show hand 
*** SUMMARY ***
Total pot €0.14 | Rake €0.01 
Board [Ts 6d 3c 5d]
Seat 2: thierryjc11 (button) folded on the Turn
Seat 4: MisterNice95 (small blind) collected (€0.13)
Seat 5: mikrethor (big blind) folded on the Flop
Seat 6: DiMiTiA folded before Flop (didn't bet)



PokerStars Hand #109564853470:  Hold'em No Limit (€0.01/€0.02 EUR) - 2014/01/04 13:06:28 CET [2014/01/04 7:06:28 ET]
Table 'Ambrosia III' 6-max Seat #4 is the button
Seat 2: thierryjc11 (€0.63 in chips) 
Seat 4: MisterNice95 (€1.12 in chips) 
Seat 5: mikrethor (€2.38 in chips) 
Seat 6: DiMiTiA (€0.59 in chips) 
mikrethor: posts small blind €0.01
DiMiTiA: posts big blind €0.02
chaim33: sits out 
*** HOLE CARDS ***
Dealt to mikrethor [2d 9s]
thierryjc11: calls €0.02
MisterNice95: calls €0.02
mikrethor: folds 
DiMiTiA: raises €0.02 to €0.04
thierryjc11: calls €0.02
MisterNice95: calls €0.02
*** FLOP *** [Kd 8s Qc]
DiMiTiA: checks 
thierryjc11: bets €0.12
MisterNice95: raises €0.12 to €0.24
DiMiTiA: folds 
thierryjc11: raises €0.35 to €0.59 and is all-in
MisterNice95: calls €0.35
*** TURN *** [Kd 8s Qc] [Qd]
*** RIVER *** [Kd 8s Qc Qd] [8c]
*** SHOW DOWN ***
thierryjc11: shows [Qh 8d] (a full house, Queens full of Eights)
MisterNice95: shows [Ks 5s] (two pair, Kings and Queens)
thierryjc11 collected €1.23 from pot
*** SUMMARY ***
Total pot €1.31 | Rake €0.08 
Board [Kd 8s Qc Qd 8c]
Seat 2: thierryjc11 showed [Qh 8d] and won (€1.23) with a full house, Queens full of Eights
Seat 4: MisterNice95 (button) showed [Ks 5s] and lost with two pair, Kings and Queens
Seat 5: mikrethor (small blind) folded before Flop
Seat 6: DiMiTiA (big blind) folded on the Flop



PokerStars Hand #109564895178:  Hold'em No Limit (€0.01/€0.02 EUR) - 2014/01/04 13:07:40 CET [2014/01/04 7:07:40 ET]
Table 'Ambrosia III' 6-max Seat #5 is the button
Seat 2: thierryjc11 (€1.23 in chips) 
Seat 4: MisterNice95 (€0.49 in chips) 
Seat 5: mikrethor (€2.37 in chips) 
Seat 6: DiMiTiA (€0.55 in chips) 
DiMiTiA: posts small blind €0.01
thierryjc11: posts big blind €0.02
chaim33: sits out 
*** HOLE CARDS ***
Dealt to mikrethor [Tc 7d]
MisterNice95: calls €0.02
mikrethor: folds 
DiMiTiA: calls €0.01
thierryjc11: checks 
*** FLOP *** [Kc 4c 9s]
DiMiTiA: bets €0.02
thierryjc11: calls €0.02
MisterNice95: folds 
*** TURN *** [Kc 4c 9s] [7c]
DiMiTiA: checks 
thierryjc11: bets €0.02
DiMiTiA: calls €0.02
*** RIVER *** [Kc 4c 9s 7c] [Kh]
DiMiTiA: checks 
thierryjc11: bets €0.06
DiMiTiA: calls €0.06
*** SHOW DOWN ***
thierryjc11: shows [5c 4s] (two pair, Kings and Fours)
DiMiTiA: shows [8s 9d] (two pair, Kings and Nines)
DiMiTiA collected €0.24 from pot
*** SUMMARY ***
Total pot €0.26 | Rake €0.02 
Board [Kc 4c 9s 7c Kh]
Seat 2: thierryjc11 (big blind) showed [5c 4s] and lost with two pair, Kings and Fours
Seat 4: MisterNice95 folded on the Flop
Seat 5: mikrethor (button) folded before Flop (didn't bet)
Seat 6: DiMiTiA (small blind) showed [8s 9d] and won (€0.24) with two pair, Kings and Nines



PokerStars Hand #109564927962:  Hold'em No Limit (€0.01/€0.02 EUR) - 2014/01/04 13:08:36 CET [2014/01/04 7:08:36 ET]
Table 'Ambrosia III' 6-max Seat #6 is the button
Seat 2: thierryjc11 (€1.11 in chips) 
Seat 3: chaim33 (€2 in chips) 
Seat 4: MisterNice95 (€0.47 in chips) 
Seat 5: mikrethor (€2.37 in chips) 
Seat 6: DiMiTiA (€0.67 in chips) 
thierryjc11: posts small blind €0.01
chaim33: posts big blind €0.02
*** HOLE CARDS ***
Dealt to mikrethor [4h 5c]
MisterNice95: folds 
mikrethor: folds 
DiMiTiA: folds 
thierryjc11: calls €0.01
chaim33: checks 
*** FLOP *** [Tc 5d Ad]
thierryjc11: bets €0.04
chaim33: folds 
Uncalled bet (€0.04) returned to thierryjc11
thierryjc11 collected €0.04 from pot
thierryjc11: doesn't show hand 
*** SUMMARY ***
Total pot €0.04 | Rake €0 
Board [Tc 5d Ad]
Seat 2: thierryjc11 (small blind) collected (€0.04)
Seat 3: chaim33 (big blind) folded on the Flop
Seat 4: MisterNice95 folded before Flop (didn't bet)
Seat 5: mikrethor folded before Flop (didn't bet)
Seat 6: DiMiTiA (button) folded before Flop (didn't bet)



PokerStars Hand #109564941477:  Hold'em No Limit (€0.01/€0.02 EUR) - 2014/01/04 13:08:59 CET [2014/01/04 7:08:59 ET]
Table 'Ambrosia III' 6-max Seat #2 is the button
Seat 2: thierryjc11 (€1.13 in chips) 
Seat 3: chaim33 (€1.98 in chips) 
Seat 4: MisterNice95 (€0.47 in chips) 
Seat 5: mikrethor (€2.37 in chips) 
Seat 6: DiMiTiA (€0.67 in chips) 
chaim33: posts small blind €0.01
MisterNice95: posts big blind €0.02
*** HOLE CARDS ***
Dealt to mikrethor [5c 3c]
mikrethor: folds 
DiMiTiA: raises €0.04 to €0.06
thierryjc11: calls €0.06
chaim33: folds 
MisterNice95: calls €0.04
*** FLOP *** [Ac 4d Ts]
MisterNice95: bets €0.08
DiMiTiA: folds 
thierryjc11: folds 
Uncalled bet (€0.08) returned to MisterNice95
MisterNice95 collected €0.18 from pot
MisterNice95: doesn't show hand 
*** SUMMARY ***
Total pot €0.19 | Rake €0.01 
Board [Ac 4d Ts]
Seat 2: thierryjc11 (button) folded on the Flop
Seat 3: chaim33 (small blind) folded before Flop
Seat 4: MisterNice95 (big blind) collected (€0.18)
Seat 5: mikrethor folded before Flop (didn't bet)
Seat 6: DiMiTiA folded on the Flop



PokerStars Hand #109564969815:  Hold'em No Limit (€0.01/€0.02 EUR) - 2014/01/04 13:09:48 CET [2014/01/04 7:09:48 ET]
Table 'Ambrosia III' 6-max Seat #3 is the button
Seat 2: thierryjc11 (€1.07 in chips) 
Seat 3: chaim33 (€2 in chips) 
Seat 4: MisterNice95 (€0.59 in chips) 
Seat 5: mikrethor (€2.37 in chips) 
Seat 6: DiMiTiA (€0.61 in chips) 
MisterNice95: posts small blind €0.01
mikrethor: posts big blind €0.02
*** HOLE CARDS ***
Dealt to mikrethor [Ac 3d]
DiMiTiA: folds 
thierryjc11: calls €0.02
DiMiTiA leaves the table
chaim33: folds 
MisterNice95: calls €0.01
mikrethor: checks 
*** FLOP *** [Ah 3c 3s]
MisterNice95: checks 
mikrethor: bets €0.02
thierryjc11: folds 
MisterNice95: folds 
Uncalled bet (€0.02) returned to mikrethor
mikrethor collected €0.06 from pot
mikrethor: doesn't show hand 
*** SUMMARY ***
Total pot €0.06 | Rake €0 
Board [Ah 3c 3s]
Seat 2: thierryjc11 folded on the Flop
Seat 3: chaim33 (button) folded before Flop (didn't bet)
Seat 4: MisterNice95 (small blind) folded on the Flop
Seat 5: mikrethor (big blind) collected (€0.06)
Seat 6: DiMiTiA folded before Flop (didn't bet)



PokerStars Hand #109564995736:  Hold'em No Limit (€0.01/€0.02 EUR) - 2014/01/04 13:10:32 CET [2014/01/04 7:10:32 ET]
Table 'Ambrosia III' 6-max Seat #4 is the button
Seat 2: thierryjc11 (€1.05 in chips) 
Seat 3: chaim33 (€2 in chips) 
Seat 4: MisterNice95 (€0.57 in chips) 
Seat 5: mikrethor (€2.41 in chips) 
mikrethor: posts small blind €0.01
thierryjc11: posts big blind €0.02
*** HOLE CARDS ***
Dealt to mikrethor [Js Kc]
chaim33: folds 
MisterNice95: folds 
mikrethor: raises €0.04 to €0.06
thierryjc11: calls €0.04
*** FLOP *** [Ah 8h 5s]
mikrethor: bets €0.04
thierryjc11: calls €0.04
*** TURN *** [Ah 8h 5s] [Qh]
mikrethor: checks 
thierryjc11: bets €0.04
mikrethor: raises €0.04 to €0.08
thierryjc11: folds 
Uncalled bet (€0.04) returned to mikrethor
mikrethor collected €0.26 from pot
mikrethor: doesn't show hand 
*** SUMMARY ***
Total pot €0.28 | Rake €0.02 
Board [Ah 8h 5s Qh]
Seat 2: thierryjc11 (big blind) folded on the Turn
Seat 3: chaim33 folded before Flop (didn't bet)
Seat 4: MisterNice95 (button) folded before Flop (didn't bet)
Seat 5: mikrethor (small blind) collected (€0.26)



PokerStars Hand #109565019356:  Hold'em No Limit (€0.01/€0.02 EUR) - 2014/01/04 13:11:13 CET [2014/01/04 7:11:13 ET]
Table 'Ambrosia III' 6-max Seat #5 is the button
Seat 2: thierryjc11 (€0.91 in chips) 
Seat 3: chaim33 (€2 in chips) 
Seat 4: MisterNice95 (€0.57 in chips) 
Seat 5: mikrethor (€2.53 in chips) 
thierryjc11: posts small blind €0.01
chaim33: posts big blind €0.02
*** HOLE CARDS ***
Dealt to mikrethor [4h 6c]
MisterNice95: calls €0.02
mikrethor: folds 
thierryjc11: calls €0.01
chaim33: raises €0.10 to €0.12
MisterNice95: folds 
thierryjc11: folds 
Uncalled bet (€0.10) returned to chaim33
chaim33 collected €0.06 from pot
chaim33: doesn't show hand 
*** SUMMARY ***
Total pot €0.06 | Rake €0 
Seat 2: thierryjc11 (small blind) folded before Flop
Seat 3: chaim33 (big blind) collected (€0.06)
Seat 4: MisterNice95 folded before Flop
Seat 5: mikrethor (button) folded before Flop (didn't bet)



PokerStars Hand #109565029702:  Hold'em No Limit (€0.01/€0.02 EUR) - 2014/01/04 13:11:30 CET [2014/01/04 7:11:30 ET]
Table 'Ambrosia III' 6-max Seat #2 is the button
Seat 2: thierryjc11 (€0.89 in chips) 
Seat 3: chaim33 (€2.04 in chips) 
Seat 4: MisterNice95 (€0.55 in chips) 
Seat 5: mikrethor (€2.53 in chips) 
chaim33: posts small blind €0.01
MisterNice95: posts big blind €0.02
*** HOLE CARDS ***
Dealt to mikrethor [4s 4d]
mikrethor: raises €0.04 to €0.06
thierryjc11: folds 
chaim33: raises €0.10 to €0.16
MisterNice95: raises €0.39 to €0.55 and is all-in
mikrethor: folds 
chaim33: calls €0.39
*** FLOP *** [Td 2c 7c]
*** TURN *** [Td 2c 7c] [9c]
*** RIVER *** [Td 2c 7c 9c] [As]
*** SHOW DOWN ***
chaim33: shows [Ah Qs] (a pair of Aces)
MisterNice95: shows [Ts Jh] (a pair of Tens)
chaim33 collected €1.09 from pot
*** SUMMARY ***
Total pot €1.16 | Rake €0.07 
Board [Td 2c 7c 9c As]
Seat 2: thierryjc11 (button) folded before Flop (didn't bet)
Seat 3: chaim33 (small blind) showed [Ah Qs] and won (€1.09) with a pair of Aces
Seat 4: MisterNice95 (big blind) showed [Ts Jh] and lost with a pair of Tens
Seat 5: mikrethor folded before Flop



PokerStars Hand #109565049789:  Hold'em No Limit (€0.01/€0.02 EUR) - 2014/01/04 13:12:04 CET [2014/01/04 7:12:04 ET]
Table 'Ambrosia III' 6-max Seat #3 is the button
Seat 2: thierryjc11 (€0.89 in chips) 
Seat 3: chaim33 (€2.58 in chips) 
Seat 5: mikrethor (€2.47 in chips) 
mikrethor: posts small blind €0.01
thierryjc11: posts big blind €0.02
*** HOLE CARDS ***
Dealt to mikrethor [5s 3s]
chaim33: folds 
MisterNice95 leaves the table
mikrethor: folds 
Uncalled bet (€0.01) returned to thierryjc11
thierryjc11 collected €0.02 from pot
thierryjc11: doesn't show hand 
*** SUMMARY ***
Total pot €0.02 | Rake €0 
Seat 2: thierryjc11 (big blind) collected (€0.02)
Seat 3: chaim33 (button) folded before Flop (didn't bet)
Seat 5: mikrethor (small blind) folded before Flop



PokerStars Hand #109565056144:  Hold'em No Limit (€0.01/€0.02 EUR) - 2014/01/04 13:12:15 CET [2014/01/04 7:12:15 ET]
Table 'Ambrosia III' 6-max Seat #5 is the button
Seat 2: thierryjc11 (€0.90 in chips) 
Seat 3: chaim33 (€2.58 in chips) 
Seat 5: mikrethor (€2.46 in chips) 
thierryjc11: posts small blind €0.01
chaim33: posts big blind €0.02
*** HOLE CARDS ***
Dealt to mikrethor [Th 4s]
mikrethor: folds 
thierryjc11: calls €0.01
chaim33: checks 
*** FLOP *** [6d 2h 4d]
thierryjc11: bets €0.04
chaim33: calls €0.04
*** TURN *** [6d 2h 4d] [5c]
thierryjc11: checks 
chaim33: bets €0.06
thierryjc11: calls €0.06
*** RIVER *** [6d 2h 4d 5c] [8d]
thierryjc11: checks 
chaim33: checks 
*** SHOW DOWN ***
thierryjc11: shows [8h Td] (a pair of Eights)
chaim33: shows [5h 4c] (two pair, Fives and Fours)
chaim33 collected €0.23 from pot
*** SUMMARY ***
Total pot €0.24 | Rake €0.01 
Board [6d 2h 4d 5c 8d]
Seat 2: thierryjc11 (small blind) showed [8h Td] and lost with a pair of Eights
Seat 3: chaim33 (big blind) showed [5h 4c] and won (€0.23) with two pair, Fives and Fours
Seat 5: mikrethor (button) folded before Flop (didn't bet)



PokerStars Hand #109565079482:  Hold'em No Limit (€0.01/€0.02 EUR) - 2014/01/04 13:12:55 CET [2014/01/04 7:12:55 ET]
Table 'Ambrosia III' 6-max Seat #2 is the button
Seat 2: thierryjc11 (€0.78 in chips) 
Seat 3: chaim33 (€2.69 in chips) 
Seat 5: mikrethor (€2.46 in chips) 
chaim33: posts small blind €0.01
mikrethor: posts big blind €0.02
*** HOLE CARDS ***
Dealt to mikrethor [3c Kh]
thierryjc11: calls €0.02
chaim33: raises €0.08 to €0.10
mikrethor: folds 
thierryjc11: folds 
Uncalled bet (€0.08) returned to chaim33
chaim33 collected €0.06 from pot
*** SUMMARY ***
Total pot €0.06 | Rake €0 
Seat 2: thierryjc11 (button) folded before Flop
Seat 3: chaim33 (small blind) collected (€0.06)
Seat 5: mikrethor (big blind) folded before Flop



PokerStars Hand #109565089360:  Hold'em No Limit (€0.01/€0.02 EUR) - 2014/01/04 13:13:11 CET [2014/01/04 7:13:11 ET]
Table 'Ambrosia III' 6-max Seat #3 is the button
Seat 2: thierryjc11 (€0.76 in chips) 
Seat 3: chaim33 (€2.73 in chips) 
Seat 5: mikrethor (€2.44 in chips) 
mikrethor: posts small blind €0.01
thierryjc11: posts big blind €0.02
*** HOLE CARDS ***
Dealt to mikrethor [7s Jh]
chaim33: raises €0.04 to €0.06
mikrethor: folds 
thierryjc11: folds 
Uncalled bet (€0.04) returned to chaim33
chaim33 collected €0.05 from pot
*** SUMMARY ***
Total pot €0.05 | Rake €0 
Seat 2: thierryjc11 (big blind) folded before Flop
Seat 3: chaim33 (button) collected (€0.05)
Seat 5: mikrethor (small blind) folded before Flop



PokerStars Hand #109565095941:  Hold'em No Limit (€0.01/€0.02 EUR) - 2014/01/04 13:13:22 CET [2014/01/04 7:13:22 ET]
Table 'Ambrosia III' 6-max Seat #5 is the button
Seat 2: thierryjc11 (€0.74 in chips) 
Seat 3: chaim33 (€2.76 in chips) 
Seat 5: mikrethor (€2.43 in chips) 
thierryjc11: posts small blind €0.01
chaim33: posts big blind €0.02
*** HOLE CARDS ***
Dealt to mikrethor [7h Tc]
mikrethor: folds 
thierryjc11: calls €0.01
chaim33: raises €0.08 to €0.10
thierryjc11: folds 
Uncalled bet (€0.08) returned to chaim33
chaim33 collected €0.04 from pot
*** SUMMARY ***
Total pot €0.04 | Rake €0 
Seat 2: thierryjc11 (small blind) folded before Flop
Seat 3: chaim33 (big blind) collected (€0.04)
Seat 5: mikrethor (button) folded before Flop (didn't bet)



PokerStars Hand #109565103733:  Hold'em No Limit (€0.01/€0.02 EUR) - 2014/01/04 13:13:35 CET [2014/01/04 7:13:35 ET]
Table 'Ambrosia III' 6-max Seat #2 is the button
Seat 2: thierryjc11 (€0.72 in chips) 
Seat 3: chaim33 (€2.78 in chips) 
Seat 5: mikrethor (€2.43 in chips) 
chaim33: posts small blind €0.01
mikrethor: posts big blind €0.02
*** HOLE CARDS ***
Dealt to mikrethor [Tc 5s]
thierryjc11: folds 
chaim33: raises €0.04 to €0.06
mikrethor: folds 
Uncalled bet (€0.04) returned to chaim33
chaim33 collected €0.04 from pot
*** SUMMARY ***
Total pot €0.04 | Rake €0 
Seat 2: thierryjc11 (button) folded before Flop (didn't bet)
Seat 3: chaim33 (small blind) collected (€0.04)
Seat 5: mikrethor (big blind) folded before Flop



PokerStars Hand #109565111174:  Hold'em No Limit (€0.01/€0.02 EUR) - 2014/01/04 13:13:48 CET [2014/01/04 7:13:48 ET]
Table 'Ambrosia III' 6-max Seat #3 is the button
Seat 2: thierryjc11 (€0.72 in chips) 
Seat 3: chaim33 (€2.80 in chips) 
Seat 5: mikrethor (€2.41 in chips) 
mikrethor: posts small blind €0.01
thierryjc11: posts big blind €0.02
*** HOLE CARDS ***
Dealt to mikrethor [9c 5h]
chaim33: folds 
mikrethor: folds 
Uncalled bet (€0.01) returned to thierryjc11
thierryjc11 collected €0.02 from pot
thierryjc11: doesn't show hand 
*** SUMMARY ***
Total pot €0.02 | Rake €0 
Seat 2: thierryjc11 (big blind) collected (€0.02)
Seat 3: chaim33 (button) folded before Flop (didn't bet)
Seat 5: mikrethor (small blind) folded before Flop



PokerStars Hand #109565115118:  Hold'em No Limit (€0.01/€0.02 EUR) - 2014/01/04 13:13:55 CET [2014/01/04 7:13:55 ET]
Table 'Ambrosia III' 6-max Seat #2 is the button
Seat 2: thierryjc11 (€0.73 in chips) 
Seat 5: mikrethor (€2.40 in chips) 
thierryjc11: posts small blind €0.01
mikrethor: posts big blind €0.02
*** HOLE CARDS ***
Dealt to mikrethor [8c 5h]
thierryjc11: calls €0.01
mikrethor: checks 
*** FLOP *** [3s 5d Jc]
mikrethor: bets €0.04
thierryjc11: calls €0.04
*** TURN *** [3s 5d Jc] [Kh]
mikrethor: checks 
thierryjc11: bets €0.04
mikrethor: calls €0.04
*** RIVER *** [3s 5d Jc Kh] [Qd]
mikrethor: checks 
thierryjc11: bets €0.06
mikrethor: calls €0.06
*** SHOW DOWN ***
thierryjc11: shows [7h 8h] (high card King)
mikrethor: shows [8c 5h] (a pair of Fives)
mikrethor collected €0.30 from pot
*** SUMMARY ***
Total pot €0.32 | Rake €0.02 
Board [3s 5d Jc Kh Qd]
Seat 2: thierryjc11 (button) (small blind) showed [7h 8h] and lost with high card King
Seat 5: mikrethor (big blind) showed [8c 5h] and won (€0.30) with a pair of Fives



PokerStars Hand #109565133268:  Hold'em No Limit (€0.01/€0.02 EUR) - 2014/01/04 13:14:25 CET [2014/01/04 7:14:25 ET]
Table 'Ambrosia III' 6-max Seat #5 is the button
Seat 2: thierryjc11 (€0.57 in chips) 
Seat 5: mikrethor (€2.54 in chips) 
mikrethor: posts small blind €0.01
thierryjc11: posts big blind €0.02
*** HOLE CARDS ***
Dealt to mikrethor [8h 2c]
mikrethor: folds 
Uncalled bet (€0.01) returned to thierryjc11
thierryjc11 collected €0.02 from pot
thierryjc11: doesn't show hand 
*** SUMMARY ***
Total pot €0.02 | Rake €0 
Seat 2: thierryjc11 (big blind) collected (€0.02)
Seat 5: mikrethor (button) (small blind) folded before Flop



PokerStars Hand #109565136453:  Hold'em No Limit (€0.01/€0.02 EUR) - 2014/01/04 13:14:31 CET [2014/01/04 7:14:31 ET]
Table 'Ambrosia III' 6-max Seat #2 is the button
Seat 2: thierryjc11 (€0.58 in chips) 
Seat 5: mikrethor (€2.53 in chips) 
thierryjc11: posts small blind €0.01
mikrethor: posts big blind €0.02
*** HOLE CARDS ***
Dealt to mikrethor [As 3h]
thierryjc11: calls €0.01
mikrethor: raises €0.04 to €0.06
thierryjc11: folds 
Uncalled bet (€0.04) returned to mikrethor
mikrethor collected €0.04 from pot
mikrethor: doesn't show hand 
*** SUMMARY ***
Total pot €0.04 | Rake €0 
Seat 2: thierryjc11 (button) (small blind) folded before Flop
Seat 5: mikrethor (big blind) collected (€0.04)



PokerStars Hand #109565144597:  Hold'em No Limit (€0.01/€0.02 EUR) - 2014/01/04 13:14:45 CET [2014/01/04 7:14:45 ET]
Table 'Ambrosia III' 6-max Seat #5 is the button
Seat 2: thierryjc11 (€0.56 in chips) 
Seat 5: mikrethor (€2.55 in chips) 
mikrethor: posts small blind €0.01
thierryjc11: posts big blind €0.02
*** HOLE CARDS ***
Dealt to mikrethor [9s 3h]
mikrethor: folds 
Uncalled bet (€0.01) returned to thierryjc11
thierryjc11 collected €0.02 from pot
thierryjc11: doesn't show hand 
*** SUMMARY ***
Total pot €0.02 | Rake €0 
Seat 2: thierryjc11 (big blind) collected (€0.02)
Seat 5: mikrethor (button) (small blind) folded before Flop



PokerStars Hand #109565147935:  Hold'em No Limit (€0.01/€0.02 EUR) - 2014/01/04 13:14:50 CET [2014/01/04 7:14:50 ET]
Table 'Ambrosia III' 6-max Seat #2 is the button
Seat 2: thierryjc11 (€0.57 in chips) 
Seat 5: mikrethor (€2.54 in chips) 
thierryjc11: posts small blind €0.01
mikrethor: posts big blind €0.02
*** HOLE CARDS ***
Dealt to mikrethor [5d Qc]
thierryjc11: calls €0.01
mikrethor: checks 
*** FLOP *** [9d Jh 7d]
mikrethor: checks 
thierryjc11: bets €0.02
mikrethor: folds 
Uncalled bet (€0.02) returned to thierryjc11
thierryjc11 collected €0.04 from pot
thierryjc11: doesn't show hand 
*** SUMMARY ***
Total pot €0.04 | Rake €0 
Board [9d Jh 7d]
Seat 2: thierryjc11 (button) (small blind) collected (€0.04)
Seat 5: mikrethor (big blind) folded on the Flop



PokerStars Hand #109565156064:  Hold'em No Limit (€0.01/€0.02 EUR) - 2014/01/04 13:15:04 CET [2014/01/04 7:15:04 ET]
Table 'Ambrosia III' 6-max Seat #5 is the button
Seat 2: thierryjc11 (€0.59 in chips) 
Seat 5: mikrethor (€2.52 in chips) 
mikrethor: posts small blind €0.01
thierryjc11: posts big blind €0.02
*** HOLE CARDS ***
Dealt to mikrethor [9h Ts]
mikrethor: raises €0.02 to €0.04
thierryjc11: calls €0.02
*** FLOP *** [Jd 4c 3d]
thierryjc11: checks 
mikrethor: checks 
*** TURN *** [Jd 4c 3d] [2h]
thierryjc11: bets €0.04
mikrethor: folds 
Uncalled bet (€0.04) returned to thierryjc11
thierryjc11 collected €0.08 from pot
thierryjc11: doesn't show hand 
*** SUMMARY ***
Total pot €0.08 | Rake €0 
Board [Jd 4c 3d 2h]
Seat 2: thierryjc11 (big blind) collected (€0.08)
Seat 5: mikrethor (button) (small blind) folded on the Turn



PokerStars Hand #109565168239:  Hold'em No Limit (€0.01/€0.02 EUR) - 2014/01/04 13:15:24 CET [2014/01/04 7:15:24 ET]
Table 'Ambrosia III' 6-max Seat #2 is the button
Seat 2: thierryjc11 (€0.63 in chips) 
Seat 5: mikrethor (€2.48 in chips) 
thierryjc11: posts small blind €0.01
mikrethor: posts big blind €0.02
*** HOLE CARDS ***
Dealt to mikrethor [Js Qh]
thierryjc11: calls €0.01
mikrethor: raises €0.04 to €0.06
thierryjc11: calls €0.04
*** FLOP *** [Td Qs 6h]
mikrethor: bets €0.10
thierryjc11: folds 
Uncalled bet (€0.10) returned to mikrethor
mikrethor collected €0.11 from pot
mikrethor: doesn't show hand 
*** SUMMARY ***
Total pot €0.12 | Rake €0.01 
Board [Td Qs 6h]
Seat 2: thierryjc11 (button) (small blind) folded on the Flop
Seat 5: mikrethor (big blind) collected (€0.11)



PokerStars Hand #109565183594:  Hold'em No Limit (€0.01/€0.02 EUR) - 2014/01/04 13:15:49 CET [2014/01/04 7:15:49 ET]
Table 'Ambrosia III' 6-max Seat #5 is the button
Seat 2: thierryjc11 (€0.57 in chips) 
Seat 5: mikrethor (€2.53 in chips) 
mikrethor: posts small blind €0.01
thierryjc11: posts big blind €0.02
*** HOLE CARDS ***
Dealt to mikrethor [Ts Kc]
mikrethor: raises €0.04 to €0.06
thierryjc11: raises €0.51 to €0.57 and is all-in
mikrethor: folds 
Uncalled bet (€0.51) returned to thierryjc11
thierryjc11 collected €0.12 from pot
thierryjc11: doesn't show hand 
*** SUMMARY ***
Total pot €0.12 | Rake €0 
Seat 2: thierryjc11 (big blind) collected (€0.12)
Seat 5: mikrethor (button) (small blind) folded before Flop



PokerStars Hand #109565199724:  Hold'em No Limit (€0.01/€0.02 EUR) - 2014/01/04 13:16:16 CET [2014/01/04 7:16:16 ET]
Table 'Ambrosia III' 6-max Seat #2 is the button
Seat 2: thierryjc11 (€0.63 in chips) 
Seat 5: mikrethor (€2.47 in chips) 
thierryjc11: posts small blind €0.01
mikrethor: posts big blind €0.02
*** HOLE CARDS ***
Dealt to mikrethor [5d 5h]
thierryjc11: folds 
Uncalled bet (€0.01) returned to mikrethor
mikrethor collected €0.02 from pot
mikrethor: doesn't show hand 
*** SUMMARY ***
Total pot €0.02 | Rake €0 
Seat 2: thierryjc11 (button) (small blind) folded before Flop
Seat 5: mikrethor (big blind) collected (€0.02)



PokerStars Hand #109565203416:  Hold'em No Limit (€0.01/€0.02 EUR) - 2014/01/04 13:16:22 CET [2014/01/04 7:16:22 ET]
Table 'Ambrosia III' 6-max Seat #5 is the button
Seat 2: thierryjc11 (€0.62 in chips) 
Seat 5: mikrethor (€2.48 in chips) 
mikrethor: posts small blind €0.01
thierryjc11: posts big blind €0.02
*** HOLE CARDS ***
Dealt to mikrethor [Kc Kh]
mikrethor: raises €0.04 to €0.06
thierryjc11: calls €0.04
*** FLOP *** [Qs Ks 8c]
thierryjc11: checks 
mikrethor: checks 
*** TURN *** [Qs Ks 8c] [Ts]
thierryjc11: bets €0.02
mikrethor: raises €0.14 to €0.16
thierryjc11: folds 
Uncalled bet (€0.14) returned to mikrethor
mikrethor collected €0.15 from pot
mikrethor: doesn't show hand 
*** SUMMARY ***
Total pot €0.16 | Rake €0.01 
Board [Qs Ks 8c Ts]
Seat 2: thierryjc11 (big blind) folded on the Turn
Seat 5: mikrethor (button) (small blind) collected (€0.15)



PokerStars Hand #109565224399:  Hold'em No Limit (€0.01/€0.02 EUR) - 2014/01/04 13:16:56 CET [2014/01/04 7:16:56 ET]
Table 'Ambrosia III' 6-max Seat #2 is the button
Seat 2: thierryjc11 (€0.54 in chips) 
Seat 5: mikrethor (€2.55 in chips) 
thierryjc11: posts small blind €0.01
mikrethor: posts big blind €0.02
*** HOLE CARDS ***
Dealt to mikrethor [7c Qd]
thierryjc11: calls €0.01
mikrethor: checks 
*** FLOP *** [5s Ks 6h]
mikrethor: checks 
thierryjc11: bets €0.04
mikrethor: folds 
Uncalled bet (€0.04) returned to thierryjc11
thierryjc11 collected €0.04 from pot
thierryjc11: doesn't show hand 
*** SUMMARY ***
Total pot €0.04 | Rake €0 
Board [5s Ks 6h]
Seat 2: thierryjc11 (button) (small blind) collected (€0.04)
Seat 5: mikrethor (big blind) folded on the Flop



PokerStars Hand #109565242116:  Hold'em No Limit (€0.01/€0.02 EUR) - 2014/01/04 13:17:26 CET [2014/01/04 7:17:26 ET]
Table 'Ambrosia III' 6-max Seat #5 is the button
Seat 2: thierryjc11 (€0.56 in chips) 
Seat 5: mikrethor (€2.53 in chips) 
mikrethor: posts small blind €0.01
thierryjc11: posts big blind €0.02
*** HOLE CARDS ***
Dealt to mikrethor [Qh Qs]
tamichebob joins the table at seat #6 
mikrethor: raises €0.04 to €0.06
thierryjc11: folds 
Uncalled bet (€0.04) returned to mikrethor
mikrethor collected €0.04 from pot
mikrethor: doesn't show hand 
*** SUMMARY ***
Total pot €0.04 | Rake €0 
Seat 2: thierryjc11 (big blind) folded before Flop
Seat 5: mikrethor (button) (small blind) collected (€0.04)



PokerStars Hand #109565258691:  Hold'em No Limit (€0.01/€0.02 EUR) - 2014/01/04 13:17:53 CET [2014/01/04 7:17:53 ET]
Table 'Ambrosia III' 6-max Seat #2 is the button
Seat 2: thierryjc11 (€0.54 in chips) 
Seat 5: mikrethor (€2.55 in chips) 
thierryjc11: posts small blind €0.01
mikrethor: posts big blind €0.02
*** HOLE CARDS ***
Dealt to mikrethor [4s Kd]
thierryjc11: calls €0.01
DoBrazil joins the table at seat #1 
mikrethor: checks 
*** FLOP *** [4c 6s 3d]
chaim33 was removed from the table for failing to post
Zoryin joins the table at seat #4 
chaim33 joins the table at seat #3 
mikrethor: bets €0.04
thierryjc11: folds 
Uncalled bet (€0.04) returned to mikrethor
mikrethor collected €0.04 from pot
mikrethor: doesn't show hand 
*** SUMMARY ***
Total pot €0.04 | Rake €0 
Board [4c 6s 3d]
Seat 2: thierryjc11 (button) (small blind) folded on the Flop
Seat 5: mikrethor (big blind) collected (€0.04)



PokerStars Hand #109565288885:  Hold'em No Limit (€0.01/€0.02 EUR) - 2014/01/04 13:18:42 CET [2014/01/04 7:18:42 ET]
Table 'Ambrosia III' 6-max Seat #2 is the button
Seat 2: thierryjc11 (€0.52 in chips) 
Seat 5: mikrethor (€2.57 in chips) 
Seat 6: tamichebob (€1 in chips) 
chaim33 will be allowed to play after the button
Zoryin will be allowed to play after the button
mikrethor: posts small blind €0.01
tamichebob: posts big blind €0.02
DoBrazil: sits out 
*** HOLE CARDS ***
Dealt to mikrethor [Tc 4d]
thierryjc11: calls €0.02
mikrethor: folds 
tamichebob: checks 
*** FLOP *** [2c 7s Ts]
tamichebob: checks 
thierryjc11: bets €0.04
tamichebob: folds 
Uncalled bet (€0.04) returned to thierryjc11
thierryjc11 collected €0.05 from pot
thierryjc11: doesn't show hand 
*** SUMMARY ***
Total pot €0.05 | Rake €0 
Board [2c 7s Ts]
Seat 2: thierryjc11 (button) collected (€0.05)
Seat 5: mikrethor (small blind) folded before Flop
Seat 6: tamichebob (big blind) folded on the Flop



PokerStars Hand #109565302186:  Hold'em No Limit (€0.01/€0.02 EUR) - 2014/01/04 13:19:04 CET [2014/01/04 7:19:04 ET]
Table 'Ambrosia III' 6-max Seat #5 is the button
Seat 1: DoBrazil (€2 in chips) 
Seat 2: thierryjc11 (€0.55 in chips) 
Seat 5: mikrethor (€2.56 in chips) 
Seat 6: tamichebob (€0.98 in chips) 
tamichebob: posts small blind €0.01
DoBrazil: posts big blind €0.02
chaim33: sits out 
Zoryin: sits out 
*** HOLE CARDS ***
Dealt to mikrethor [Qs 7s]
thierryjc11: calls €0.02
mikrethor: calls €0.02
tamichebob: calls €0.01
DoBrazil: checks 
*** FLOP *** [Th 2h Kc]
tamichebob: checks 
DoBrazil: checks 
thierryjc11: bets €0.02
mikrethor: folds 
tamichebob: folds 
DoBrazil: folds 
Uncalled bet (€0.02) returned to thierryjc11
thierryjc11 collected €0.08 from pot
thierryjc11: doesn't show hand 
*** SUMMARY ***
Total pot €0.08 | Rake €0 
Board [Th 2h Kc]
Seat 1: DoBrazil (big blind) folded on the Flop
Seat 2: thierryjc11 collected (€0.08)
Seat 5: mikrethor (button) folded on the Flop
Seat 6: tamichebob (small blind) folded on the Flop



PokerStars Hand #109565324223:  Hold'em No Limit (€0.01/€0.02 EUR) - 2014/01/04 13:19:41 CET [2014/01/04 7:19:41 ET]
Table 'Ambrosia III' 6-max Seat #6 is the button
Seat 1: DoBrazil (€1.98 in chips) 
Seat 2: thierryjc11 (€0.61 in chips) 
Seat 5: mikrethor (€2.54 in chips) 
Seat 6: tamichebob (€0.96 in chips) 
DoBrazil: posts small blind €0.01
thierryjc11: posts big blind €0.02
chaim33: sits out 
Zoryin: sits out 
*** HOLE CARDS ***
Dealt to mikrethor [Th 2s]
mikrethor: folds 
tamichebob: calls €0.02
DoBrazil: folds 
thierryjc11: checks 
*** FLOP *** [Ac 5s 6c]
thierryjc11: bets €0.04
tamichebob: calls €0.04
*** TURN *** [Ac 5s 6c] [3c]
thierryjc11: checks 
tamichebob: checks 
*** RIVER *** [Ac 5s 6c 3c] [As]
thierryjc11: bets €0.06
tamichebob: calls €0.06
*** SHOW DOWN ***
thierryjc11: shows [8c Js] (a pair of Aces)
tamichebob: shows [Ad Qc] (three of a kind, Aces)
tamichebob collected €0.23 from pot
*** SUMMARY ***
Total pot €0.25 | Rake €0.02 
Board [Ac 5s 6c 3c As]
Seat 1: DoBrazil (small blind) folded before Flop
Seat 2: thierryjc11 (big blind) showed [8c Js] and lost with a pair of Aces
Seat 5: mikrethor folded before Flop (didn't bet)
Seat 6: tamichebob (button) showed [Ad Qc] and won (€0.23) with three of a kind, Aces



PokerStars Hand #109565348411:  Hold'em No Limit (€0.01/€0.02 EUR) - 2014/01/04 13:20:20 CET [2014/01/04 7:20:20 ET]
Table 'Ambrosia III' 6-max Seat #1 is the button
Seat 1: DoBrazil (€1.97 in chips) 
Seat 2: thierryjc11 (€0.49 in chips) 
Seat 3: chaim33 (€2.80 in chips) 
Seat 5: mikrethor (€2.54 in chips) 
Seat 6: tamichebob (€1.07 in chips) 
thierryjc11: posts small blind €0.01
chaim33: posts big blind €0.02
Zoryin: sits out 
*** HOLE CARDS ***
Dealt to mikrethor [4c 8s]
mikrethor: folds 
tamichebob: calls €0.02
DoBrazil: calls €0.02
thierryjc11: calls €0.01
chaim33: checks 
*** FLOP *** [Th 7h 2h]
thierryjc11: bets €0.02
chaim33: folds 
tamichebob: raises €0.06 to €0.08
DoBrazil: folds 
thierryjc11: folds 
Uncalled bet (€0.06) returned to tamichebob
tamichebob collected €0.11 from pot
tamichebob: doesn't show hand 
*** SUMMARY ***
Total pot €0.12 | Rake €0.01 
Board [Th 7h 2h]
Seat 1: DoBrazil (button) folded on the Flop
Seat 2: thierryjc11 (small blind) folded on the Flop
Seat 3: chaim33 (big blind) folded on the Flop
Seat 5: mikrethor folded before Flop (didn't bet)
Seat 6: tamichebob collected (€0.11)



PokerStars Hand #109565372269:  Hold'em No Limit (€0.01/€0.02 EUR) - 2014/01/04 13:21:00 CET [2014/01/04 7:21:00 ET]
Table 'Ambrosia III' 6-max Seat #2 is the button
Seat 1: DoBrazil (€1.95 in chips) 
Seat 2: thierryjc11 (€0.45 in chips) 
Seat 3: chaim33 (€2.78 in chips) 
Seat 4: Zoryin (€2 in chips) 
Seat 5: mikrethor (€2.54 in chips) 
Seat 6: tamichebob (€1.14 in chips) 
chaim33: posts small blind €0.01
Zoryin: posts big blind €0.02
*** HOLE CARDS ***
Dealt to mikrethor [Kc 7d]
mikrethor: folds 
tamichebob: folds 
DoBrazil: folds 
thierryjc11: folds 
chaim33: raises €0.04 to €0.06
Zoryin: folds 
Uncalled bet (€0.04) returned to chaim33
chaim33 collected €0.04 from pot
*** SUMMARY ***
Total pot €0.04 | Rake €0 
Seat 1: DoBrazil folded before Flop (didn't bet)
Seat 2: thierryjc11 (button) folded before Flop (didn't bet)
Seat 3: chaim33 (small blind) collected (€0.04)
Seat 4: Zoryin (big blind) folded before Flop
Seat 5: mikrethor folded before Flop (didn't bet)
Seat 6: tamichebob folded before Flop (didn't bet)



PokerStars Hand #109565382344:  Hold'em No Limit (€0.01/€0.02 EUR) - 2014/01/04 13:21:16 CET [2014/01/04 7:21:16 ET]
Table 'Ambrosia III' 6-max Seat #3 is the button
Seat 1: DoBrazil (€1.95 in chips) 
Seat 2: thierryjc11 (€0.45 in chips) 
Seat 3: chaim33 (€2.80 in chips) 
Seat 4: Zoryin (€2 in chips) 
Seat 5: mikrethor (€2.54 in chips) 
Seat 6: tamichebob (€1.14 in chips) 
Zoryin: posts small blind €0.01
mikrethor: posts big blind €0.02
*** HOLE CARDS ***
Dealt to mikrethor [2h Jd]
tamichebob: folds 
DoBrazil: folds 
thierryjc11: calls €0.02
chaim33: folds 
Zoryin: folds 
mikrethor: checks 
*** FLOP *** [Ks 3c Td]
mikrethor: checks 
thierryjc11: bets €0.04
mikrethor: folds 
Uncalled bet (€0.04) returned to thierryjc11
thierryjc11 collected €0.05 from pot
thierryjc11: doesn't show hand 
*** SUMMARY ***
Total pot €0.05 | Rake €0 
Board [Ks 3c Td]
Seat 1: DoBrazil folded before Flop (didn't bet)
Seat 2: thierryjc11 collected (€0.05)
Seat 3: chaim33 (button) folded before Flop (didn't bet)
Seat 4: Zoryin (small blind) folded before Flop
Seat 5: mikrethor (big blind) folded on the Flop
Seat 6: tamichebob folded before Flop (didn't bet)



PokerStars Hand #109565397950:  Hold'em No Limit (€0.01/€0.02 EUR) - 2014/01/04 13:21:42 CET [2014/01/04 7:21:42 ET]
Table 'Ambrosia III' 6-max Seat #4 is the button
Seat 1: DoBrazil (€1.95 in chips) 
Seat 2: thierryjc11 (€0.48 in chips) 
Seat 3: chaim33 (€2.80 in chips) 
Seat 4: Zoryin (€2 in chips) 
Seat 5: mikrethor (€2.52 in chips) 
Seat 6: tamichebob (€1.14 in chips) 
mikrethor: posts small blind €0.01
tamichebob: posts big blind €0.02
*** HOLE CARDS ***
Dealt to mikrethor [2h 7d]
DoBrazil: calls €0.02
thierryjc11: folds 
chaim33: raises €0.08 to €0.10
Zoryin: folds 
mikrethor: folds 
tamichebob: folds 
DoBrazil: calls €0.08
*** FLOP *** [Td 8h 8d]
DoBrazil: checks 
chaim33: bets €0.10
DoBrazil: folds 
Uncalled bet (€0.10) returned to chaim33
chaim33 collected €0.22 from pot
*** SUMMARY ***
Total pot €0.23 | Rake €0.01 
Board [Td 8h 8d]
Seat 1: DoBrazil folded on the Flop
Seat 2: thierryjc11 folded before Flop (didn't bet)
Seat 3: chaim33 collected (€0.22)
Seat 4: Zoryin (button) folded before Flop (didn't bet)
Seat 5: mikrethor (small blind) folded before Flop
Seat 6: tamichebob (big blind) folded before Flop



PokerStars Hand #109565421033:  Hold'em No Limit (€0.01/€0.02 EUR) - 2014/01/04 13:22:19 CET [2014/01/04 7:22:19 ET]
Table 'Ambrosia III' 6-max Seat #5 is the button
Seat 1: DoBrazil (€2 in chips) 
Seat 2: thierryjc11 (€0.48 in chips) 
Seat 3: chaim33 (€2.92 in chips) 
Seat 4: Zoryin (€2 in chips) 
Seat 5: mikrethor (€2.51 in chips) 
Seat 6: tamichebob (€1.12 in chips) 
tamichebob: posts small blind €0.01
DoBrazil: posts big blind €0.02
*** HOLE CARDS ***
Dealt to mikrethor [7c 6c]
thierryjc11: folds 
chaim33: folds 
Zoryin: raises €0.06 to €0.08
mikrethor: folds 
tamichebob: folds 
DoBrazil: folds 
Uncalled bet (€0.06) returned to Zoryin
Zoryin collected €0.05 from pot
Zoryin: doesn't show hand 
*** SUMMARY ***
Total pot €0.05 | Rake €0 
Seat 1: DoBrazil (big blind) folded before Flop
Seat 2: thierryjc11 folded before Flop (didn't bet)
Seat 3: chaim33 folded before Flop (didn't bet)
Seat 4: Zoryin collected (€0.05)
Seat 5: mikrethor (button) folded before Flop (didn't bet)
Seat 6: tamichebob (small blind) folded before Flop



PokerStars Hand #109565431588:  Hold'em No Limit (€0.01/€0.02 EUR) - 2014/01/04 13:22:36 CET [2014/01/04 7:22:36 ET]
Table 'Ambrosia III' 6-max Seat #6 is the button
Seat 1: DoBrazil (€1.98 in chips) 
Seat 2: thierryjc11 (€0.48 in chips) 
Seat 3: chaim33 (€2.92 in chips) 
Seat 4: Zoryin (€2.03 in chips) 
Seat 5: mikrethor (€2.51 in chips) 
Seat 6: tamichebob (€1.11 in chips) 
DoBrazil: posts small blind €0.01
thierryjc11: posts big blind €0.02
*** HOLE CARDS ***
Dealt to mikrethor [Th 5d]
chaim33: folds 
Zoryin: raises €0.06 to €0.08
mikrethor: folds 
tamichebob: folds 
DoBrazil: folds 
thierryjc11: folds 
Uncalled bet (€0.06) returned to Zoryin
Zoryin collected €0.05 from pot
Zoryin: doesn't show hand 
*** SUMMARY ***
Total pot €0.05 | Rake €0 
Seat 1: DoBrazil (small blind) folded before Flop
Seat 2: thierryjc11 (big blind) folded before Flop
Seat 3: chaim33 folded before Flop (didn't bet)
Seat 4: Zoryin collected (€0.05)
Seat 5: mikrethor folded before Flop (didn't bet)
Seat 6: tamichebob (button) folded before Flop (didn't bet)



PokerStars Hand #109565442710:  Hold'em No Limit (€0.01/€0.02 EUR) - 2014/01/04 13:22:54 CET [2014/01/04 7:22:54 ET]
Table 'Ambrosia III' 6-max Seat #1 is the button
Seat 1: DoBrazil (€1.97 in chips) 
Seat 2: thierryjc11 (€0.46 in chips) 
Seat 3: chaim33 (€2.92 in chips) 
Seat 4: Zoryin (€2.06 in chips) 
Seat 5: mikrethor (€2.51 in chips) 
Seat 6: tamichebob (€1.11 in chips) 
thierryjc11: posts small blind €0.01
chaim33: posts big blind €0.02
*** HOLE CARDS ***
Dealt to mikrethor [5d As]
Zoryin: folds 
mikrethor: folds 
tamichebob: folds 
DoBrazil: folds 
thierryjc11: calls €0.01
chaim33: raises €0.08 to €0.10
thierryjc11: calls €0.08
*** FLOP *** [8h Th 3h]
thierryjc11: checks 
chaim33: bets €0.18
thierryjc11: folds 
Uncalled bet (€0.18) returned to chaim33
chaim33 collected €0.19 from pot
chaim33: doesn't show hand 
*** SUMMARY ***
Total pot €0.20 | Rake €0.01 
Board [8h Th 3h]
Seat 1: DoBrazil (button) folded before Flop (didn't bet)
Seat 2: thierryjc11 (small blind) folded on the Flop
Seat 3: chaim33 (big blind) collected (€0.19)
Seat 4: Zoryin folded before Flop (didn't bet)
Seat 5: mikrethor folded before Flop (didn't bet)
Seat 6: tamichebob folded before Flop (didn't bet)



PokerStars Hand #109565461587:  Hold'em No Limit (€0.01/€0.02 EUR) - 2014/01/04 13:23:26 CET [2014/01/04 7:23:26 ET]
Table 'Ambrosia III' 6-max Seat #2 is the button
Seat 1: DoBrazil (€1.97 in chips) 
Seat 2: thierryjc11 (€0.36 in chips) 
Seat 3: chaim33 (€3.01 in chips) 
Seat 4: Zoryin (€2.06 in chips) 
Seat 5: mikrethor (€2.51 in chips) 
Seat 6: tamichebob (€1.11 in chips) 
chaim33: posts small blind €0.01
Zoryin: posts big blind €0.02
*** HOLE CARDS ***
Dealt to mikrethor [Tc Js]
mikrethor: folds 
tamichebob: folds 
DoBrazil: folds 
thierryjc11: calls €0.02
chaim33: folds 
Zoryin: checks 
*** FLOP *** [Ah 5c Kc]
Zoryin: checks 
thierryjc11: bets €0.04
Zoryin: folds 
Uncalled bet (€0.04) returned to thierryjc11
thierryjc11 collected €0.05 from pot
thierryjc11: doesn't show hand 
*** SUMMARY ***
Total pot €0.05 | Rake €0 
Board [Ah 5c Kc]
Seat 1: DoBrazil folded before Flop (didn't bet)
Seat 2: thierryjc11 (button) collected (€0.05)
Seat 3: chaim33 (small blind) folded before Flop
Seat 4: Zoryin (big blind) folded on the Flop
Seat 5: mikrethor folded before Flop (didn't bet)
Seat 6: tamichebob folded before Flop (didn't bet)



PokerStars Hand #109565481942:  Hold'em No Limit (€0.01/€0.02 EUR) - 2014/01/04 13:23:59 CET [2014/01/04 7:23:59 ET]
Table 'Ambrosia III' 6-max Seat #3 is the button
Seat 1: DoBrazil (€1.97 in chips) 
Seat 2: thierryjc11 (€0.39 in chips) 
Seat 3: chaim33 (€3 in chips) 
Seat 4: Zoryin (€2.04 in chips) 
Seat 5: mikrethor (€2.51 in chips) 
Seat 6: tamichebob (€1.11 in chips) 
Zoryin: posts small blind €0.01
mikrethor: posts big blind €0.02
*** HOLE CARDS ***
Dealt to mikrethor [Tc 6s]
tamichebob: calls €0.02
DoBrazil: folds 
thierryjc11: calls €0.02
chaim33: raises €0.10 to €0.12
Zoryin: folds 
mikrethor: folds 
tamichebob: folds 
thierryjc11: folds 
Uncalled bet (€0.10) returned to chaim33
chaim33 collected €0.09 from pot
*** SUMMARY ***
Total pot €0.09 | Rake €0 
Seat 1: DoBrazil folded before Flop (didn't bet)
Seat 2: thierryjc11 folded before Flop
Seat 3: chaim33 (button) collected (€0.09)
Seat 4: Zoryin (small blind) folded before Flop
Seat 5: mikrethor (big blind) folded before Flop
Seat 6: tamichebob folded before Flop



PokerStars Hand #109565497125:  Hold'em No Limit (€0.01/€0.02 EUR) - 2014/01/04 13:24:24 CET [2014/01/04 7:24:24 ET]
Table 'Ambrosia III' 6-max Seat #4 is the button
Seat 1: DoBrazil (€1.97 in chips) 
Seat 2: thierryjc11 (€0.37 in chips) 
Seat 3: chaim33 (€3.07 in chips) 
Seat 4: Zoryin (€2.03 in chips) 
Seat 5: mikrethor (€2.49 in chips) 
Seat 6: tamichebob (€1.09 in chips) 
mikrethor: posts small blind €0.01
tamichebob: posts big blind €0.02
*** HOLE CARDS ***
Dealt to mikrethor [2d Ks]
DoBrazil: folds 
thierryjc11: folds 
chaim33: raises €0.04 to €0.06
Zoryin: calls €0.06
mikrethor: folds 
tamichebob: calls €0.04
*** FLOP *** [4h Qs Td]
tamichebob: checks 
chaim33: checks 
Zoryin: checks 
*** TURN *** [4h Qs Td] [8c]
tamichebob: checks 
chaim33: checks 
Zoryin: checks 
*** RIVER *** [4h Qs Td 8c] [8s]
tamichebob: checks 
chaim33: checks 
Zoryin: checks 
*** SHOW DOWN ***
tamichebob: shows [Ts 9s] (two pair, Tens and Eights)
chaim33: mucks hand 
Zoryin: mucks hand 
tamichebob collected €0.18 from pot
*** SUMMARY ***
Total pot €0.19 | Rake €0.01 
Board [4h Qs Td 8c 8s]
Seat 1: DoBrazil folded before Flop (didn't bet)
Seat 2: thierryjc11 folded before Flop (didn't bet)
Seat 3: chaim33 mucked [As 4s]
Seat 4: Zoryin (button) mucked [Ad 9d]
Seat 5: mikrethor (small blind) folded before Flop
Seat 6: tamichebob (big blind) showed [Ts 9s] and won (€0.18) with two pair, Tens and Eights



PokerStars Hand #109565533562:  Hold'em No Limit (€0.01/€0.02 EUR) - 2014/01/04 13:25:24 CET [2014/01/04 7:25:24 ET]
Table 'Ambrosia III' 6-max Seat #5 is the button
Seat 1: DoBrazil (€1.97 in chips) 
Seat 2: thierryjc11 (€0.37 in chips) 
Seat 3: chaim33 (€3.01 in chips) 
Seat 4: Zoryin (€2 in chips) 
Seat 5: mikrethor (€2.48 in chips) 
Seat 6: tamichebob (€1.21 in chips) 
tamichebob: posts small blind €0.01
DoBrazil: posts big blind €0.02
*** HOLE CARDS ***
Dealt to mikrethor [Ts 2h]
thierryjc11: calls €0.02
chaim33: raises €0.08 to €0.10
Zoryin: folds 
mikrethor: folds 
tamichebob: folds 
DoBrazil: folds 
thierryjc11: folds 
Uncalled bet (€0.08) returned to chaim33
chaim33 collected €0.07 from pot
*** SUMMARY ***
Total pot €0.07 | Rake €0 
Seat 1: DoBrazil (big blind) folded before Flop
Seat 2: thierryjc11 folded before Flop
Seat 3: chaim33 collected (€0.07)
Seat 4: Zoryin folded before Flop (didn't bet)
Seat 5: mikrethor (button) folded before Flop (didn't bet)
Seat 6: tamichebob (small blind) folded before Flop



PokerStars Hand #109565546958:  Hold'em No Limit (€0.01/€0.02 EUR) - 2014/01/04 13:25:46 CET [2014/01/04 7:25:46 ET]
Table 'Ambrosia III' 6-max Seat #6 is the button
Seat 1: DoBrazil (€1.95 in chips) 
Seat 2: thierryjc11 (€0.35 in chips) 
Seat 3: chaim33 (€3.06 in chips) 
Seat 4: Zoryin (€2 in chips) 
Seat 5: mikrethor (€2.48 in chips) 
Seat 6: tamichebob (€1.20 in chips) 
DoBrazil: posts small blind €0.01
thierryjc11: posts big blind €0.02
*** HOLE CARDS ***
Dealt to mikrethor [9d 2c]
chaim33: folds 
Zoryin: folds 
mikrethor: folds 
tamichebob: calls €0.02
DoBrazil: calls €0.01
thierryjc11: raises €0.33 to €0.35 and is all-in
tamichebob: folds 
DoBrazil: folds 
Uncalled bet (€0.33) returned to thierryjc11
thierryjc11 collected €0.06 from pot
thierryjc11: doesn't show hand 
*** SUMMARY ***
Total pot €0.06 | Rake €0 
Seat 1: DoBrazil (small blind) folded before Flop
Seat 2: thierryjc11 (big blind) collected (€0.06)
Seat 3: chaim33 folded before Flop (didn't bet)
Seat 4: Zoryin folded before Flop (didn't bet)
Seat 5: mikrethor folded before Flop (didn't bet)
Seat 6: tamichebob (button) folded before Flop



PokerStars Hand #109565558321:  Hold'em No Limit (€0.01/€0.02 EUR) - 2014/01/04 13:26:04 CET [2014/01/04 7:26:04 ET]
Table 'Ambrosia III' 6-max Seat #1 is the button
Seat 1: DoBrazil (€2 in chips) 
Seat 2: thierryjc11 (€0.39 in chips) 
Seat 3: chaim33 (€3.06 in chips) 
Seat 4: Zoryin (€2 in chips) 
Seat 5: mikrethor (€2.48 in chips) 
Seat 6: tamichebob (€1.18 in chips) 
thierryjc11: posts small blind €0.01
chaim33: posts big blind €0.02
*** HOLE CARDS ***
Dealt to mikrethor [Ac 6h]
Zoryin: folds 
mikrethor: folds 
tamichebob: folds 
DoBrazil: folds 
thierryjc11: calls €0.01
chaim33: checks 
*** FLOP *** [4s 2d 6d]
thierryjc11: bets €0.04
chaim33: calls €0.04
*** TURN *** [4s 2d 6d] [Ks]
thierryjc11: checks 
chaim33: checks 
*** RIVER *** [4s 2d 6d Ks] [7s]
thierryjc11: bets €0.06
chaim33: calls €0.06
*** SHOW DOWN ***
thierryjc11: shows [8s 9c] (high card King)
chaim33: shows [As 5c] (high card Ace)
chaim33 collected €0.23 from pot
*** SUMMARY ***
Total pot €0.24 | Rake €0.01 
Board [4s 2d 6d Ks 7s]
Seat 1: DoBrazil (button) folded before Flop (didn't bet)
Seat 2: thierryjc11 (small blind) showed [8s 9c] and lost with high card King
Seat 3: chaim33 (big blind) showed [As 5c] and won (€0.23) with high card Ace
Seat 4: Zoryin folded before Flop (didn't bet)
Seat 5: mikrethor folded before Flop (didn't bet)
Seat 6: tamichebob folded before Flop (didn't bet)



PokerStars Hand #109565581844:  Hold'em No Limit (€0.01/€0.02 EUR) - 2014/01/04 13:26:44 CET [2014/01/04 7:26:44 ET]
Table 'Ambrosia III' 6-max Seat #2 is the button
Seat 1: DoBrazil (€2 in chips) 
Seat 2: thierryjc11 (€0.27 in chips) 
Seat 3: chaim33 (€3.17 in chips) 
Seat 4: Zoryin (€2 in chips) 
Seat 5: mikrethor (€2.48 in chips) 
Seat 6: tamichebob (€1.18 in chips) 
chaim33: posts small blind €0.01
Zoryin: posts big blind €0.02
*** HOLE CARDS ***
Dealt to mikrethor [Ah Ts]
mikrethor: raises €0.04 to €0.06
tamichebob: calls €0.06
DoBrazil: folds 
thierryjc11: calls €0.06
chaim33: folds 
Zoryin: folds 
*** FLOP *** [2c 7d 3c]
mikrethor: checks 
tamichebob: checks 
thierryjc11: bets €0.21 and is all-in
mikrethor: calls €0.21
tamichebob: folds 
*** TURN *** [2c 7d 3c] [5d]
*** RIVER *** [2c 7d 3c 5d] [9h]
*** SHOW DOWN ***
mikrethor: shows [Ah Ts] (high card Ace)
thierryjc11: shows [5h 5c] (three of a kind, Fives)
thierryjc11 collected €0.59 from pot
*** SUMMARY ***
Total pot €0.63 | Rake €0.04 
Board [2c 7d 3c 5d 9h]
Seat 1: DoBrazil folded before Flop (didn't bet)
Seat 2: thierryjc11 (button) showed [5h 5c] and won (€0.59) with three of a kind, Fives
Seat 3: chaim33 (small blind) folded before Flop
Seat 4: Zoryin (big blind) folded before Flop
Seat 5: mikrethor showed [Ah Ts] and lost with high card Ace
Seat 6: tamichebob folded on the Flop



PokerStars Hand #109565609455:  Hold'em No Limit (€0.01/€0.02 EUR) - 2014/01/04 13:27:29 CET [2014/01/04 7:27:29 ET]
Table 'Ambrosia III' 6-max Seat #3 is the button
Seat 1: DoBrazil (€2 in chips) 
Seat 2: thierryjc11 (€0.59 in chips) 
Seat 3: chaim33 (€3.16 in chips) 
Seat 4: Zoryin (€2 in chips) 
Seat 5: mikrethor (€2.21 in chips) 
Seat 6: tamichebob (€1.12 in chips) 
Zoryin: posts small blind €0.01
mikrethor: posts big blind €0.02
*** HOLE CARDS ***
Dealt to mikrethor [3h 7d]
tamichebob: folds 
DoBrazil: folds 
thierryjc11: calls €0.02
chaim33: folds 
Zoryin: folds 
mikrethor: checks 
*** FLOP *** [Qd Jc 4s]
mikrethor: checks 
thierryjc11: bets €0.04
mikrethor: folds 
Uncalled bet (€0.04) returned to thierryjc11
thierryjc11 collected €0.05 from pot
thierryjc11: doesn't show hand 
*** SUMMARY ***
Total pot €0.05 | Rake €0 
Board [Qd Jc 4s]
Seat 1: DoBrazil folded before Flop (didn't bet)
Seat 2: thierryjc11 collected (€0.05)
Seat 3: chaim33 (button) folded before Flop (didn't bet)
Seat 4: Zoryin (small blind) folded before Flop
Seat 5: mikrethor (big blind) folded on the Flop
Seat 6: tamichebob folded before Flop (didn't bet)



PokerStars Hand #109565629416:  Hold'em No Limit (€0.01/€0.02 EUR) - 2014/01/04 13:28:01 CET [2014/01/04 7:28:01 ET]
Table 'Ambrosia III' 6-max Seat #4 is the button
Seat 1: DoBrazil (€2 in chips) 
Seat 2: thierryjc11 (€0.62 in chips) 
Seat 3: chaim33 (€3.16 in chips) 
Seat 4: Zoryin (€2 in chips) 
Seat 5: mikrethor (€2.19 in chips) 
Seat 6: tamichebob (€1.12 in chips) 
mikrethor: posts small blind €0.01
tamichebob: posts big blind €0.02
*** HOLE CARDS ***
Dealt to mikrethor [5c 8c]
DoBrazil: folds 
thierryjc11: folds 
chaim33: folds 
Zoryin: raises €0.04 to €0.06
mikrethor: calls €0.05
tamichebob: folds 
*** FLOP *** [3c Qc Ts]
mikrethor: bets €0.06
Zoryin: folds 
Uncalled bet (€0.06) returned to mikrethor
mikrethor collected €0.13 from pot
mikrethor: doesn't show hand 
*** SUMMARY ***
Total pot €0.14 | Rake €0.01 
Board [3c Qc Ts]
Seat 1: DoBrazil folded before Flop (didn't bet)
Seat 2: thierryjc11 folded before Flop (didn't bet)
Seat 3: chaim33 folded before Flop (didn't bet)
Seat 4: Zoryin (button) folded on the Flop
Seat 5: mikrethor (small blind) collected (€0.13)
Seat 6: tamichebob (big blind) folded before Flop



PokerStars Hand #109565648775:  Hold'em No Limit (€0.01/€0.02 EUR) - 2014/01/04 13:28:33 CET [2014/01/04 7:28:33 ET]
Table 'Ambrosia III' 6-max Seat #5 is the button
Seat 1: DoBrazil (€2 in chips) 
Seat 2: thierryjc11 (€0.62 in chips) 
Seat 3: chaim33 (€3.16 in chips) 
Seat 4: Zoryin (€2 in chips) 
Seat 5: mikrethor (€2.26 in chips) 
Seat 6: tamichebob (€1.10 in chips) 
tamichebob: posts small blind €0.01
DoBrazil: posts big blind €0.02
*** HOLE CARDS ***
Dealt to mikrethor [2h 8d]
thierryjc11: calls €0.02
chaim33: folds 
Zoryin: folds 
mikrethor: folds 
tamichebob: calls €0.01
DoBrazil: checks 
*** FLOP *** [Jd As Js]
tamichebob: checks 
DoBrazil: checks 
thierryjc11: bets €0.04
tamichebob: folds 
DoBrazil: folds 
Uncalled bet (€0.04) returned to thierryjc11
thierryjc11 collected €0.06 from pot
thierryjc11: doesn't show hand 
*** SUMMARY ***
Total pot €0.06 | Rake €0 
Board [Jd As Js]
Seat 1: DoBrazil (big blind) folded on the Flop
Seat 2: thierryjc11 collected (€0.06)
Seat 3: chaim33 folded before Flop (didn't bet)
Seat 4: Zoryin folded before Flop (didn't bet)
Seat 5: mikrethor (button) folded before Flop (didn't bet)
Seat 6: tamichebob (small blind) folded on the Flop



PokerStars Hand #109565665337:  Hold'em No Limit (€0.01/€0.02 EUR) - 2014/01/04 13:29:00 CET [2014/01/04 7:29:00 ET]
Table 'Ambrosia III' 6-max Seat #6 is the button
Seat 1: DoBrazil (€1.98 in chips) 
Seat 2: thierryjc11 (€0.66 in chips) 
Seat 3: chaim33 (€3.16 in chips) 
Seat 4: Zoryin (€2 in chips) 
Seat 5: mikrethor (€2.26 in chips) 
Seat 6: tamichebob (€1.08 in chips) 
DoBrazil: posts small blind €0.01
thierryjc11: posts big blind €0.02
*** HOLE CARDS ***
Dealt to mikrethor [4c 8d]
chaim33: raises €0.04 to €0.06
Zoryin: folds 
mikrethor: folds 
tamichebob: folds 
DoBrazil: folds 
thierryjc11: folds 
Uncalled bet (€0.04) returned to chaim33
chaim33 collected €0.05 from pot
*** SUMMARY ***
Total pot €0.05 | Rake €0 
Seat 1: DoBrazil (small blind) folded before Flop
Seat 2: thierryjc11 (big blind) folded before Flop
Seat 3: chaim33 collected (€0.05)
Seat 4: Zoryin folded before Flop (didn't bet)
Seat 5: mikrethor folded before Flop (didn't bet)
Seat 6: tamichebob (button) folded before Flop (didn't bet)



PokerStars Hand #109565673902:  Hold'em No Limit (€0.01/€0.02 EUR) - 2014/01/04 13:29:14 CET [2014/01/04 7:29:14 ET]
Table 'Ambrosia III' 6-max Seat #1 is the button
Seat 1: DoBrazil (€1.97 in chips) 
Seat 2: thierryjc11 (€0.64 in chips) 
Seat 3: chaim33 (€3.19 in chips) 
Seat 4: Zoryin (€2 in chips) 
Seat 5: mikrethor (€2.26 in chips) 
Seat 6: tamichebob (€1.08 in chips) 
thierryjc11: posts small blind €0.01
chaim33: posts big blind €0.02
*** HOLE CARDS ***
Dealt to mikrethor [Qs Td]
Zoryin: folds 
mikrethor: calls €0.02
tamichebob: folds 
DoBrazil: folds 
thierryjc11: calls €0.01
chaim33: checks 
*** FLOP *** [As 6c 7c]
thierryjc11: bets €0.02
chaim33: calls €0.02
mikrethor: folds 
*** TURN *** [As 6c 7c] [Ks]
thierryjc11: bets €0.02
chaim33: calls €0.02
*** RIVER *** [As 6c 7c Ks] [3c]
thierryjc11: bets €0.04
chaim33: calls €0.04
*** SHOW DOWN ***
thierryjc11: shows [6h Qh] (a pair of Sixes)
chaim33: shows [9d Ah] (a pair of Aces)
chaim33 collected €0.21 from pot
*** SUMMARY ***
Total pot €0.22 | Rake €0.01 
Board [As 6c 7c Ks 3c]
Seat 1: DoBrazil (button) folded before Flop (didn't bet)
Seat 2: thierryjc11 (small blind) showed [6h Qh] and lost with a pair of Sixes
Seat 3: chaim33 (big blind) showed [9d Ah] and won (€0.21) with a pair of Aces
Seat 4: Zoryin folded before Flop (didn't bet)
Seat 5: mikrethor folded on the Flop
Seat 6: tamichebob folded before Flop (didn't bet)



PokerStars Hand #109565699269:  Hold'em No Limit (€0.01/€0.02 EUR) - 2014/01/04 13:29:56 CET [2014/01/04 7:29:56 ET]
Table 'Ambrosia III' 6-max Seat #2 is the button
Seat 1: DoBrazil (€1.97 in chips) 
Seat 2: thierryjc11 (€0.54 in chips) 
Seat 3: chaim33 (€3.30 in chips) 
Seat 4: Zoryin (€2 in chips) 
Seat 5: mikrethor (€2.24 in chips) 
Seat 6: tamichebob (€1.08 in chips) 
chaim33: posts small blind €0.01
Zoryin: posts big blind €0.02
*** HOLE CARDS ***
Dealt to mikrethor [7s 2s]
mikrethor: folds 
tamichebob: folds 
DoBrazil: folds 
thierryjc11: calls €0.02
chaim33: folds 
Zoryin: checks 
*** FLOP *** [Js 9h 9d]
Zoryin: checks 
thierryjc11: bets €0.04
Zoryin: folds 
Uncalled bet (€0.04) returned to thierryjc11
thierryjc11 collected €0.05 from pot
thierryjc11: doesn't show hand 
*** SUMMARY ***
Total pot €0.05 | Rake €0 
Board [Js 9h 9d]
Seat 1: DoBrazil folded before Flop (didn't bet)
Seat 2: thierryjc11 (button) collected (€0.05)
Seat 3: chaim33 (small blind) folded before Flop
Seat 4: Zoryin (big blind) folded on the Flop
Seat 5: mikrethor folded before Flop (didn't bet)
Seat 6: tamichebob folded before Flop (didn't bet)



PokerStars Hand #109565714361:  Hold'em No Limit (€0.01/€0.02 EUR) - 2014/01/04 13:30:20 CET [2014/01/04 7:30:20 ET]
Table 'Ambrosia III' 6-max Seat #3 is the button
Seat 1: DoBrazil (€1.97 in chips) 
Seat 2: thierryjc11 (€0.57 in chips) 
Seat 3: chaim33 (€3.29 in chips) 
Seat 4: Zoryin (€2 in chips) 
Seat 5: mikrethor (€2.24 in chips) 
Seat 6: tamichebob (€1.08 in chips) 
Zoryin: posts small blind €0.01
mikrethor: posts big blind €0.02
*** HOLE CARDS ***
Dealt to mikrethor [Js Ac]
tamichebob: folds 
DoBrazil: folds 
thierryjc11: calls €0.02
chaim33: folds 
Zoryin: calls €0.01
mikrethor: raises €0.06 to €0.08
thierryjc11: folds 
Zoryin: folds 
Uncalled bet (€0.06) returned to mikrethor
mikrethor collected €0.06 from pot
mikrethor: doesn't show hand 
*** SUMMARY ***
Total pot €0.06 | Rake €0 
Seat 1: DoBrazil folded before Flop (didn't bet)
Seat 2: thierryjc11 folded before Flop
Seat 3: chaim33 (button) folded before Flop (didn't bet)
Seat 4: Zoryin (small blind) folded before Flop
Seat 5: mikrethor (big blind) collected (€0.06)
Seat 6: tamichebob folded before Flop (didn't bet)



PokerStars Hand #109565737316:  Hold'em No Limit (€0.01/€0.02 EUR) - 2014/01/04 13:30:57 CET [2014/01/04 7:30:57 ET]
Table 'Ambrosia III' 6-max Seat #4 is the button
Seat 1: DoBrazil (€1.97 in chips) 
Seat 2: thierryjc11 (€0.55 in chips) 
Seat 3: chaim33 (€3.29 in chips) 
Seat 4: Zoryin (€2 in chips) 
Seat 5: mikrethor (€2.28 in chips) 
Seat 6: tamichebob (€1.08 in chips) 
mikrethor: posts small blind €0.01
tamichebob: posts big blind €0.02
*** HOLE CARDS ***
Dealt to mikrethor [7d 2d]
DoBrazil: folds 
thierryjc11: calls €0.02
chaim33: folds 
Zoryin: folds 
mikrethor: folds 
tamichebob: checks 
*** FLOP *** [2h Js Ts]
tamichebob: checks 
thierryjc11: bets €0.04
tamichebob: folds 
Uncalled bet (€0.04) returned to thierryjc11
thierryjc11 collected €0.05 from pot
thierryjc11: doesn't show hand 
*** SUMMARY ***
Total pot €0.05 | Rake €0 
Board [2h Js Ts]
Seat 1: DoBrazil folded before Flop (didn't bet)
Seat 2: thierryjc11 collected (€0.05)
Seat 3: chaim33 folded before Flop (didn't bet)
Seat 4: Zoryin (button) folded before Flop (didn't bet)
Seat 5: mikrethor (small blind) folded before Flop
Seat 6: tamichebob (big blind) folded on the Flop



PokerStars Hand #109565755118:  Hold'em No Limit (€0.01/€0.02 EUR) - 2014/01/04 13:31:26 CET [2014/01/04 7:31:26 ET]
Table 'Ambrosia III' 6-max Seat #5 is the button
Seat 1: DoBrazil (€1.97 in chips) 
Seat 2: thierryjc11 (€0.58 in chips) 
Seat 3: chaim33 (€3.29 in chips) 
Seat 4: Zoryin (€2 in chips) 
Seat 5: mikrethor (€2.27 in chips) 
Seat 6: tamichebob (€1.06 in chips) 
tamichebob: posts small blind €0.01
DoBrazil: posts big blind €0.02
*** HOLE CARDS ***
Dealt to mikrethor [2s 9h]
thierryjc11: calls €0.02
chaim33: folds 
Zoryin: raises €0.08 to €0.10
mikrethor: folds 
tamichebob: folds 
DoBrazil: folds 
thierryjc11: folds 
Uncalled bet (€0.08) returned to Zoryin
Zoryin collected €0.07 from pot
Zoryin: doesn't show hand 
*** SUMMARY ***
Total pot €0.07 | Rake €0 
Seat 1: DoBrazil (big blind) folded before Flop
Seat 2: thierryjc11 folded before Flop
Seat 3: chaim33 folded before Flop (didn't bet)
Seat 4: Zoryin collected (€0.07)
Seat 5: mikrethor (button) folded before Flop (didn't bet)
Seat 6: tamichebob (small blind) folded before Flop



PokerStars Hand #109565764646:  Hold'em No Limit (€0.01/€0.02 EUR) - 2014/01/04 13:31:42 CET [2014/01/04 7:31:42 ET]
Table 'Ambrosia III' 6-max Seat #6 is the button
Seat 1: DoBrazil (€1.95 in chips) 
Seat 2: thierryjc11 (€0.56 in chips) 
Seat 3: chaim33 (€3.29 in chips) 
Seat 4: Zoryin (€2.05 in chips) 
Seat 5: mikrethor (€2.27 in chips) 
Seat 6: tamichebob (€1.05 in chips) 
DoBrazil: posts small blind €0.01
thierryjc11: posts big blind €0.02
*** HOLE CARDS ***
Dealt to mikrethor [As Kd]
chaim33: folds 
Zoryin: raises €0.06 to €0.08
mikrethor: raises €0.10 to €0.18
tamichebob: folds 
DoBrazil: folds 
thierryjc11: folds 
Zoryin: raises €1.87 to €2.05 and is all-in
mikrethor: calls €1.87
*** FLOP *** [Td 3h 6c]
*** TURN *** [Td 3h 6c] [Ts]
*** RIVER *** [Td 3h 6c Ts] [Tc]
*** SHOW DOWN ***
Zoryin: shows [Kc Ah] (three of a kind, Tens)
mikrethor: shows [As Kd] (three of a kind, Tens)
Zoryin collected €1.94 from pot
mikrethor collected €1.94 from pot
*** SUMMARY ***
Total pot €4.13 | Rake €0.25 
Board [Td 3h 6c Ts Tc]
Seat 1: DoBrazil (small blind) folded before Flop
Seat 2: thierryjc11 (big blind) folded before Flop
Seat 3: chaim33 folded before Flop (didn't bet)
Seat 4: Zoryin showed [Kc Ah] and won (€1.94) with three of a kind, Tens
Seat 5: mikrethor showed [As Kd] and won (€1.94) with three of a kind, Tens
Seat 6: tamichebob (button) folded before Flop (didn't bet)



PokerStars Hand #109565786546:  Hold'em No Limit (€0.01/€0.02 EUR) - 2014/01/04 13:32:17 CET [2014/01/04 7:32:17 ET]
Table 'Ambrosia III' 6-max Seat #1 is the button
Seat 1: DoBrazil (€1.94 in chips) 
Seat 2: thierryjc11 (€0.54 in chips) 
Seat 3: chaim33 (€3.29 in chips) 
Seat 4: Zoryin (€2 in chips) 
Seat 5: mikrethor (€2.16 in chips) 
Seat 6: tamichebob (€1.05 in chips) 
thierryjc11: posts small blind €0.01
chaim33: posts big blind €0.02
*** HOLE CARDS ***
Dealt to mikrethor [Ah 3s]
Zoryin: folds 
mikrethor: folds 
tamichebob: folds 
DoBrazil: raises €0.06 to €0.08
thierryjc11: calls €0.07
chaim33: raises €0.20 to €0.28
DoBrazil: folds 
thierryjc11: folds 
Uncalled bet (€0.20) returned to chaim33
chaim33 collected €0.24 from pot
*** SUMMARY ***
Total pot €0.24 | Rake €0 
Seat 1: DoBrazil (button) folded before Flop
Seat 2: thierryjc11 (small blind) folded before Flop
Seat 3: chaim33 (big blind) collected (€0.24)
Seat 4: Zoryin folded before Flop (didn't bet)
Seat 5: mikrethor folded before Flop (didn't bet)
Seat 6: tamichebob folded before Flop (didn't bet)



PokerStars Hand #109565809271:  Hold'em No Limit (€0.01/€0.02 EUR) - 2014/01/04 13:32:54 CET [2014/01/04 7:32:54 ET]
Table 'Ambrosia III' 6-max Seat #2 is the button
Seat 1: DoBrazil (€2 in chips) 
Seat 2: thierryjc11 (€0.46 in chips) 
Seat 3: chaim33 (€3.45 in chips) 
Seat 4: Zoryin (€2 in chips) 
Seat 5: mikrethor (€2.16 in chips) 
Seat 6: tamichebob (€1.05 in chips) 
chaim33: posts small blind €0.01
Zoryin: posts big blind €0.02
*** HOLE CARDS ***
Dealt to mikrethor [2c As]
mikrethor: folds 
tamichebob: folds 
DoBrazil: folds 
thierryjc11: folds 
chaim33: folds 
Uncalled bet (€0.01) returned to Zoryin
Zoryin collected €0.02 from pot
Zoryin: doesn't show hand 
*** SUMMARY ***
Total pot €0.02 | Rake €0 
Seat 1: DoBrazil folded before Flop (didn't bet)
Seat 2: thierryjc11 (button) folded before Flop (didn't bet)
Seat 3: chaim33 (small blind) folded before Flop
Seat 4: Zoryin (big blind) collected (€0.02)
Seat 5: mikrethor folded before Flop (didn't bet)
Seat 6: tamichebob folded before Flop (didn't bet)



PokerStars Hand #109565816007:  Hold'em No Limit (€0.01/€0.02 EUR) - 2014/01/04 13:33:04 CET [2014/01/04 7:33:04 ET]
Table 'Ambrosia III' 6-max Seat #3 is the button
Seat 1: DoBrazil (€2 in chips) 
Seat 2: thierryjc11 (€0.46 in chips) 
Seat 3: chaim33 (€3.44 in chips) 
Seat 4: Zoryin (€2.01 in chips) 
Seat 5: mikrethor (€2.16 in chips) 
Seat 6: tamichebob (€1.05 in chips) 
Zoryin: posts small blind €0.01
mikrethor: posts big blind €0.02
*** HOLE CARDS ***
Dealt to mikrethor [3h 5s]
tamichebob: folds 
DoBrazil: folds 
thierryjc11: folds 
chaim33: folds 
Zoryin: folds 
Uncalled bet (€0.01) returned to mikrethor
mikrethor collected €0.02 from pot
mikrethor: doesn't show hand 
*** SUMMARY ***
Total pot €0.02 | Rake €0 
Seat 1: DoBrazil folded before Flop (didn't bet)
Seat 2: thierryjc11 folded before Flop (didn't bet)
Seat 3: chaim33 (button) folded before Flop (didn't bet)
Seat 4: Zoryin (small blind) folded before Flop
Seat 5: mikrethor (big blind) collected (€0.02)
Seat 6: tamichebob folded before Flop (didn't bet)



PokerStars Hand #109565824880:  Hold'em No Limit (€0.01/€0.02 EUR) - 2014/01/04 13:33:19 CET [2014/01/04 7:33:19 ET]
Table 'Ambrosia III' 6-max Seat #4 is the button
Seat 1: DoBrazil (€2 in chips) 
Seat 2: thierryjc11 (€0.46 in chips) 
Seat 3: chaim33 (€3.44 in chips) 
Seat 4: Zoryin (€2 in chips) 
Seat 5: mikrethor (€2.17 in chips) 
Seat 6: tamichebob (€1.05 in chips) 
mikrethor: posts small blind €0.01
tamichebob: posts big blind €0.02
*** HOLE CARDS ***
Dealt to mikrethor [2d Ks]
DoBrazil: folds 
thierryjc11: folds 
chaim33: folds 
Zoryin: raises €0.04 to €0.06
mikrethor: folds 
tamichebob: calls €0.04
*** FLOP *** [4c 6c 6s]
tamichebob: checks 
Zoryin: bets €0.06
tamichebob: calls €0.06
*** TURN *** [4c 6c 6s] [4h]
tamichebob: checks 
Zoryin: checks 
*** RIVER *** [4c 6c 6s 4h] [6d]
tamichebob: checks 
Zoryin: checks 
*** SHOW DOWN ***
tamichebob: shows [5s 5c] (a full house, Sixes full of Fives)
Zoryin: mucks hand 
tamichebob collected €0.23 from pot
*** SUMMARY ***
Total pot €0.25 | Rake €0.02 
Board [4c 6c 6s 4h 6d]
Seat 1: DoBrazil folded before Flop (didn't bet)
Seat 2: thierryjc11 folded before Flop (didn't bet)
Seat 3: chaim33 folded before Flop (didn't bet)
Seat 4: Zoryin (button) mucked [8h Jh]
Seat 5: mikrethor (small blind) folded before Flop
Seat 6: tamichebob (big blind) showed [5s 5c] and won (€0.23) with a full house, Sixes full of Fives



PokerStars Hand #109565848350:  Hold'em No Limit (€0.01/€0.02 EUR) - 2014/01/04 13:33:57 CET [2014/01/04 7:33:57 ET]
Table 'Ambrosia III' 6-max Seat #5 is the button
Seat 1: DoBrazil (€2 in chips) 
Seat 2: thierryjc11 (€0.46 in chips) 
Seat 3: chaim33 (€3.44 in chips) 
Seat 4: Zoryin (€2 in chips) 
Seat 5: mikrethor (€2.16 in chips) 
Seat 6: tamichebob (€1.16 in chips) 
tamichebob: posts small blind €0.01
DoBrazil: posts big blind €0.02
*** HOLE CARDS ***
Dealt to mikrethor [4s Ad]
thierryjc11: calls €0.02
chaim33: folds 
Zoryin: folds 
mikrethor: folds 
tamichebob: folds 
DoBrazil: checks 
*** FLOP *** [3c Jh 5c]
DoBrazil: checks 
thierryjc11: bets €0.04
DoBrazil: folds 
Uncalled bet (€0.04) returned to thierryjc11
thierryjc11 collected €0.05 from pot
thierryjc11: doesn't show hand 
*** SUMMARY ***
Total pot €0.05 | Rake €0 
Board [3c Jh 5c]
Seat 1: DoBrazil (big blind) folded on the Flop
Seat 2: thierryjc11 collected (€0.05)
Seat 3: chaim33 folded before Flop (didn't bet)
Seat 4: Zoryin folded before Flop (didn't bet)
Seat 5: mikrethor (button) folded before Flop (didn't bet)
Seat 6: tamichebob (small blind) folded before Flop



PokerStars Hand #109565869366:  Hold'em No Limit (€0.01/€0.02 EUR) - 2014/01/04 13:34:30 CET [2014/01/04 7:34:30 ET]
Table 'Ambrosia III' 6-max Seat #6 is the button
Seat 1: DoBrazil (€1.98 in chips) 
Seat 2: thierryjc11 (€0.49 in chips) 
Seat 3: chaim33 (€3.44 in chips) 
Seat 4: Zoryin (€2 in chips) 
Seat 5: mikrethor (€2.16 in chips) 
Seat 6: tamichebob (€1.15 in chips) 
DoBrazil: posts small blind €0.01
thierryjc11: posts big blind €0.02
*** HOLE CARDS ***
Dealt to mikrethor [Qc 4h]
chaim33: raises €0.04 to €0.06
Zoryin: folds 
mikrethor: folds 
tamichebob: folds 
DoBrazil: folds 
thierryjc11: folds 
Uncalled bet (€0.04) returned to chaim33
chaim33 collected €0.05 from pot
*** SUMMARY ***
Total pot €0.05 | Rake €0 
Seat 1: DoBrazil (small blind) folded before Flop
Seat 2: thierryjc11 (big blind) folded before Flop
Seat 3: chaim33 collected (€0.05)
Seat 4: Zoryin folded before Flop (didn't bet)
Seat 5: mikrethor folded before Flop (didn't bet)
Seat 6: tamichebob (button) folded before Flop (didn't bet)



PokerStars Hand #109565879729:  Hold'em No Limit (€0.01/€0.02 EUR) - 2014/01/04 13:34:47 CET [2014/01/04 7:34:47 ET]
Table 'Ambrosia III' 6-max Seat #1 is the button
Seat 1: DoBrazil (€1.97 in chips) 
Seat 2: thierryjc11 (€0.47 in chips) 
Seat 3: chaim33 (€3.47 in chips) 
Seat 4: Zoryin (€2 in chips) 
Seat 5: mikrethor (€2.16 in chips) 
Seat 6: tamichebob (€1.15 in chips) 
thierryjc11: posts small blind €0.01
chaim33: posts big blind €0.02
*** HOLE CARDS ***
Dealt to mikrethor [5h Qs]
Zoryin: folds 
mikrethor: folds 
tamichebob: calls €0.02
DoBrazil: folds 
thierryjc11: calls €0.01
chaim33: checks 
*** FLOP *** [2h Ad 2d]
thierryjc11: bets €0.02
chaim33: folds 
tamichebob: calls €0.02
*** TURN *** [2h Ad 2d] [4c]
thierryjc11: checks 
tamichebob: checks 
*** RIVER *** [2h Ad 2d 4c] [7h]
thierryjc11: bets €0.04
tamichebob: folds 
Uncalled bet (€0.04) returned to thierryjc11
thierryjc11 collected €0.09 from pot
thierryjc11: doesn't show hand 
*** SUMMARY ***
Total pot €0.10 | Rake €0.01 
Board [2h Ad 2d 4c 7h]
Seat 1: DoBrazil (button) folded before Flop (didn't bet)
Seat 2: thierryjc11 (small blind) collected (€0.09)
Seat 3: chaim33 (big blind) folded on the Flop
Seat 4: Zoryin folded before Flop (didn't bet)
Seat 5: mikrethor folded before Flop (didn't bet)
Seat 6: tamichebob folded on the River



PokerStars Hand #109565902518:  Hold'em No Limit (€0.01/€0.02 EUR) - 2014/01/04 13:35:23 CET [2014/01/04 7:35:23 ET]
Table 'Ambrosia III' 6-max Seat #2 is the button
Seat 1: DoBrazil (€1.97 in chips) 
Seat 2: thierryjc11 (€0.52 in chips) 
Seat 3: chaim33 (€3.45 in chips) 
Seat 4: Zoryin (€2 in chips) 
Seat 5: mikrethor (€2.16 in chips) 
Seat 6: tamichebob (€1.11 in chips) 
chaim33: posts small blind €0.01
Zoryin: posts big blind €0.02
*** HOLE CARDS ***
Dealt to mikrethor [6d Qs]
mikrethor: folds 
tamichebob: folds 
DoBrazil: folds 
thierryjc11: calls €0.02
chaim33: raises €0.08 to €0.10
Zoryin: folds 
thierryjc11: folds 
Uncalled bet (€0.08) returned to chaim33
chaim33 collected €0.06 from pot
*** SUMMARY ***
Total pot €0.06 | Rake €0 
Seat 1: DoBrazil folded before Flop (didn't bet)
Seat 2: thierryjc11 (button) folded before Flop
Seat 3: chaim33 (small blind) collected (€0.06)
Seat 4: Zoryin (big blind) folded before Flop
Seat 5: mikrethor folded before Flop (didn't bet)
Seat 6: tamichebob folded before Flop (didn't bet)



PokerStars Hand #109565914427:  Hold'em No Limit (€0.01/€0.02 EUR) - 2014/01/04 13:35:42 CET [2014/01/04 7:35:42 ET]
Table 'Ambrosia III' 6-max Seat #3 is the button
Seat 1: DoBrazil (€1.97 in chips) 
Seat 2: thierryjc11 (€0.50 in chips) 
Seat 3: chaim33 (€3.49 in chips) 
Seat 4: Zoryin (€2 in chips) 
Seat 5: mikrethor (€2.16 in chips) 
Seat 6: tamichebob (€1.11 in chips) 
Zoryin: posts small blind €0.01
mikrethor: posts big blind €0.02
*** HOLE CARDS ***
Dealt to mikrethor [5h Jd]
tamichebob: folds 
DoBrazil: folds 
thierryjc11: folds 
chaim33: raises €0.04 to €0.06
Zoryin: folds 
mikrethor: folds 
Uncalled bet (€0.04) returned to chaim33
chaim33 collected €0.05 from pot
*** SUMMARY ***
Total pot €0.05 | Rake €0 
Seat 1: DoBrazil folded before Flop (didn't bet)
Seat 2: thierryjc11 folded before Flop (didn't bet)
Seat 3: chaim33 (button) collected (€0.05)
Seat 4: Zoryin (small blind) folded before Flop
Seat 5: mikrethor (big blind) folded before Flop
Seat 6: tamichebob folded before Flop (didn't bet)



PokerStars Hand #109565922395:  Hold'em No Limit (€0.01/€0.02 EUR) - 2014/01/04 13:35:54 CET [2014/01/04 7:35:54 ET]
Table 'Ambrosia III' 6-max Seat #4 is the button
Seat 1: DoBrazil (€1.97 in chips) 
Seat 2: thierryjc11 (€0.50 in chips) 
Seat 3: chaim33 (€3.52 in chips) 
Seat 4: Zoryin (€2 in chips) 
Seat 5: mikrethor (€2.14 in chips) 
Seat 6: tamichebob (€1.11 in chips) 
mikrethor: posts small blind €0.01
tamichebob: posts big blind €0.02
*** HOLE CARDS ***
Dealt to mikrethor [9d 9c]
DoBrazil: folds 
thierryjc11: calls €0.02
chaim33: folds 
Zoryin: folds 
mikrethor: raises €0.08 to €0.10
tamichebob: calls €0.08
thierryjc11: folds 
*** FLOP *** [2d 5d 4h]
mikrethor: bets €0.20
tamichebob: folds 
Uncalled bet (€0.20) returned to mikrethor
mikrethor collected €0.21 from pot
mikrethor: doesn't show hand 
*** SUMMARY ***
Total pot €0.22 | Rake €0.01 
Board [2d 5d 4h]
Seat 1: DoBrazil folded before Flop (didn't bet)
Seat 2: thierryjc11 folded before Flop
Seat 3: chaim33 folded before Flop (didn't bet)
Seat 4: Zoryin (button) folded before Flop (didn't bet)
Seat 5: mikrethor (small blind) collected (€0.21)
Seat 6: tamichebob (big blind) folded on the Flop



PokerStars Hand #109565947092:  Hold'em No Limit (€0.01/€0.02 EUR) - 2014/01/04 13:36:33 CET [2014/01/04 7:36:33 ET]
Table 'Ambrosia III' 6-max Seat #5 is the button
Seat 1: DoBrazil (€1.97 in chips) 
Seat 2: thierryjc11 (€0.48 in chips) 
Seat 3: chaim33 (€3.52 in chips) 
Seat 4: Zoryin (€2 in chips) 
Seat 5: mikrethor (€2.25 in chips) 
Seat 6: tamichebob (€1.01 in chips) 
tamichebob: posts small blind €0.01
DoBrazil: posts big blind €0.02
*** HOLE CARDS ***
Dealt to mikrethor [2s 5s]
thierryjc11: calls €0.02
chaim33: folds 
Zoryin: folds 
mikrethor: folds 
tamichebob: raises €0.06 to €0.08
DoBrazil: folds 
thierryjc11: folds 
Uncalled bet (€0.06) returned to tamichebob
tamichebob collected €0.06 from pot
tamichebob: doesn't show hand 
*** SUMMARY ***
Total pot €0.06 | Rake €0 
Seat 1: DoBrazil (big blind) folded before Flop
Seat 2: thierryjc11 folded before Flop
Seat 3: chaim33 folded before Flop (didn't bet)
Seat 4: Zoryin folded before Flop (didn't bet)
Seat 5: mikrethor (button) folded before Flop (didn't bet)
Seat 6: tamichebob (small blind) collected (€0.06)



PokerStars Hand #109565958670:  Hold'em No Limit (€0.01/€0.02 EUR) - 2014/01/04 13:36:52 CET [2014/01/04 7:36:52 ET]
Table 'Ambrosia III' 6-max Seat #6 is the button
Seat 1: DoBrazil (€1.95 in chips) 
Seat 2: thierryjc11 (€0.46 in chips) 
Seat 3: chaim33 (€3.52 in chips) 
Seat 4: Zoryin (€2 in chips) 
Seat 5: mikrethor (€2.25 in chips) 
Seat 6: tamichebob (€1.05 in chips) 
DoBrazil: posts small blind €0.01
thierryjc11: posts big blind €0.02
*** HOLE CARDS ***
Dealt to mikrethor [Kc 5c]
chaim33: folds 
Zoryin: folds 
mikrethor: raises €0.30 to €0.32
tamichebob: folds 
DoBrazil: folds 
thierryjc11: folds 
Uncalled bet (€0.30) returned to mikrethor
mikrethor collected €0.05 from pot
mikrethor: doesn't show hand 
*** SUMMARY ***
Total pot €0.05 | Rake €0 
Seat 1: DoBrazil (small blind) folded before Flop
Seat 2: thierryjc11 (big blind) folded before Flop
Seat 3: chaim33 folded before Flop (didn't bet)
Seat 4: Zoryin folded before Flop (didn't bet)
Seat 5: mikrethor collected (€0.05)
Seat 6: tamichebob (button) folded before Flop (didn't bet)



PokerStars Hand #109565975489:  Hold'em No Limit (€0.01/€0.02 EUR) - 2014/01/04 13:37:18 CET [2014/01/04 7:37:18 ET]
Table 'Ambrosia III' 6-max Seat #1 is the button
Seat 1: DoBrazil (€1.94 in chips) 
Seat 2: thierryjc11 (€0.44 in chips) 
Seat 3: chaim33 (€3.52 in chips) 
Seat 4: Zoryin (€2 in chips) 
Seat 5: mikrethor (€2.28 in chips) 
Seat 6: tamichebob (€1.05 in chips) 
thierryjc11: posts small blind €0.01
chaim33: posts big blind €0.02
*** HOLE CARDS ***
Dealt to mikrethor [3d Jh]
Zoryin: folds 
mikrethor: folds 
tamichebob: calls €0.02
DoBrazil: folds 
thierryjc11: calls €0.01
chaim33: checks 
*** FLOP *** [7h 5s Js]
thierryjc11: bets €0.02
chaim33: folds 
tamichebob: folds 
Uncalled bet (€0.02) returned to thierryjc11
thierryjc11 collected €0.06 from pot
thierryjc11: doesn't show hand 
*** SUMMARY ***
Total pot €0.06 | Rake €0 
Board [7h 5s Js]
Seat 1: DoBrazil (button) folded before Flop (didn't bet)
Seat 2: thierryjc11 (small blind) collected (€0.06)
Seat 3: chaim33 (big blind) folded on the Flop
Seat 4: Zoryin folded before Flop (didn't bet)
Seat 5: mikrethor folded before Flop (didn't bet)
Seat 6: tamichebob folded on the Flop



PokerStars Hand #109565990728:  Hold'em No Limit (€0.01/€0.02 EUR) - 2014/01/04 13:37:42 CET [2014/01/04 7:37:42 ET]
Table 'Ambrosia III' 6-max Seat #2 is the button
Seat 1: DoBrazil (€1.94 in chips) 
Seat 2: thierryjc11 (€0.48 in chips) 
Seat 3: chaim33 (€3.50 in chips) 
Seat 4: Zoryin (€2 in chips) 
Seat 5: mikrethor (€2.28 in chips) 
Seat 6: tamichebob (€1.03 in chips) 
chaim33: posts small blind €0.01
Zoryin: posts big blind €0.02
*** HOLE CARDS ***
Dealt to mikrethor [3c 6s]
mikrethor: folds 
tamichebob: calls €0.02
DoBrazil: folds 
thierryjc11: calls €0.02
chaim33: folds 
Zoryin: raises €0.08 to €0.10
tamichebob: folds 
thierryjc11: folds 
Uncalled bet (€0.08) returned to Zoryin
Zoryin collected €0.07 from pot
Zoryin: doesn't show hand 
*** SUMMARY ***
Total pot €0.07 | Rake €0 
Seat 1: DoBrazil folded before Flop (didn't bet)
Seat 2: thierryjc11 (button) folded before Flop
Seat 3: chaim33 (small blind) folded before Flop
Seat 4: Zoryin (big blind) collected (€0.07)
Seat 5: mikrethor folded before Flop (didn't bet)
Seat 6: tamichebob folded before Flop



PokerStars Hand #109566005611:  Hold'em No Limit (€0.01/€0.02 EUR) - 2014/01/04 13:38:06 CET [2014/01/04 7:38:06 ET]
Table 'Ambrosia III' 6-max Seat #3 is the button
Seat 1: DoBrazil (€1.94 in chips) 
Seat 2: thierryjc11 (€0.46 in chips) 
Seat 3: chaim33 (€3.49 in chips) 
Seat 4: Zoryin (€2.05 in chips) 
Seat 5: mikrethor (€2.28 in chips) 
Seat 6: tamichebob (€1.01 in chips) 
Zoryin: posts small blind €0.01
mikrethor: posts big blind €0.02
*** HOLE CARDS ***
Dealt to mikrethor [Ac 2s]
tamichebob: raises €0.04 to €0.06
DoBrazil: folds 
thierryjc11: calls €0.06
chaim33: folds 
Zoryin: folds 
mikrethor: folds 
*** FLOP *** [6c 3s 8h]
tamichebob: bets €0.08
thierryjc11: calls €0.08
*** TURN *** [6c 3s 8h] [7s]
tamichebob: bets €0.28
thierryjc11: calls €0.28
*** RIVER *** [6c 3s 8h 7s] [6h]
tamichebob: checks 
thierryjc11: bets €0.04 and is all-in
tamichebob: calls €0.04
*** SHOW DOWN ***
thierryjc11: shows [9d 7d] (two pair, Sevens and Sixes)
tamichebob: shows [Qc Qh] (two pair, Queens and Sixes)
tamichebob collected €0.89 from pot
*** SUMMARY ***
Total pot €0.95 | Rake €0.06 
Board [6c 3s 8h 7s 6h]
Seat 1: DoBrazil folded before Flop (didn't bet)
Seat 2: thierryjc11 showed [9d 7d] and lost with two pair, Sevens and Sixes
Seat 3: chaim33 (button) folded before Flop (didn't bet)
Seat 4: Zoryin (small blind) folded before Flop
Seat 5: mikrethor (big blind) folded before Flop
Seat 6: tamichebob showed [Qc Qh] and won (€0.89) with two pair, Queens and Sixes



PokerStars Hand #109566043325:  Hold'em No Limit (€0.01/€0.02 EUR) - 2014/01/04 13:39:06 CET [2014/01/04 7:39:06 ET]
Table 'Ambrosia III' 6-max Seat #4 is the button
Seat 1: DoBrazil (€1.94 in chips) 
Seat 3: chaim33 (€3.49 in chips) 
Seat 4: Zoryin (€2.04 in chips) 
Seat 5: mikrethor (€2.26 in chips) 
Seat 6: tamichebob (€1.44 in chips) 
mikrethor: posts small blind €0.01
tamichebob: posts big blind €0.02
*** HOLE CARDS ***
Dealt to mikrethor [Qh 6d]
DoBrazil: folds 
chaim33: folds 
Zoryin: raises €0.04 to €0.06
mikrethor: folds 
tamichebob: folds 
Uncalled bet (€0.04) returned to Zoryin
Zoryin collected €0.05 from pot
Zoryin: doesn't show hand 
*** SUMMARY ***
Total pot €0.05 | Rake €0 
Seat 1: DoBrazil folded before Flop (didn't bet)
Seat 3: chaim33 folded before Flop (didn't bet)
Seat 4: Zoryin (button) collected (€0.05)
Seat 5: mikrethor (small blind) folded before Flop
Seat 6: tamichebob (big blind) folded before Flop



PokerStars Hand #109566052792:  Hold'em No Limit (€0.01/€0.02 EUR) - 2014/01/04 13:39:21 CET [2014/01/04 7:39:21 ET]
Table 'Ambrosia III' 6-max Seat #5 is the button
Seat 1: DoBrazil (€1.94 in chips) 
Seat 2: thierryjc11 (€1.03 in chips) 
Seat 3: chaim33 (€3.49 in chips) 
Seat 4: Zoryin (€2.07 in chips) 
Seat 5: mikrethor (€2.25 in chips) 
Seat 6: tamichebob (€1.42 in chips) 
tamichebob: posts small blind €0.01
DoBrazil: posts big blind €0.02
*** HOLE CARDS ***
Dealt to mikrethor [Qs Ah]
thierryjc11: calls €0.02
chaim33: folds 
Zoryin: folds 
mikrethor: raises €0.08 to €0.10
tamichebob: folds 
DoBrazil: folds 
thierryjc11: calls €0.08
*** FLOP *** [8c 8d 7d]
thierryjc11: checks 
mikrethor: bets €0.18
thierryjc11: folds 
Uncalled bet (€0.18) returned to mikrethor
mikrethor collected €0.22 from pot
mikrethor: doesn't show hand 
*** SUMMARY ***
Total pot €0.23 | Rake €0.01 
Board [8c 8d 7d]
Seat 1: DoBrazil (big blind) folded before Flop
Seat 2: thierryjc11 folded on the Flop
Seat 3: chaim33 folded before Flop (didn't bet)
Seat 4: Zoryin folded before Flop (didn't bet)
Seat 5: mikrethor (button) collected (€0.22)
Seat 6: tamichebob (small blind) folded before Flop



PokerStars Hand #109566068382:  Hold'em No Limit (€0.01/€0.02 EUR) - 2014/01/04 13:39:45 CET [2014/01/04 7:39:45 ET]
Table 'Ambrosia III' 6-max Seat #6 is the button
Seat 1: DoBrazil (€2 in chips) 
Seat 2: thierryjc11 (€0.93 in chips) 
Seat 3: chaim33 (€3.49 in chips) 
Seat 4: Zoryin (€2.07 in chips) 
Seat 5: mikrethor (€2.37 in chips) 
Seat 6: tamichebob (€1.41 in chips) 
DoBrazil: posts small blind €0.01
thierryjc11: posts big blind €0.02
*** HOLE CARDS ***
Dealt to mikrethor [Ah 9d]
chaim33: folds 
Zoryin: folds 
mikrethor: raises €0.04 to €0.06
tamichebob: folds 
DoBrazil: calls €0.05
thierryjc11: calls €0.04
*** FLOP *** [Js 4h 6c]
DoBrazil: checks 
thierryjc11: checks 
mikrethor: bets €0.08
DoBrazil: raises €0.22 to €0.30
thierryjc11: folds 
mikrethor: folds 
Uncalled bet (€0.22) returned to DoBrazil
DoBrazil collected €0.32 from pot
*** SUMMARY ***
Total pot €0.34 | Rake €0.02 
Board [Js 4h 6c]
Seat 1: DoBrazil (small blind) collected (€0.32)
Seat 2: thierryjc11 (big blind) folded on the Flop
Seat 3: chaim33 folded before Flop (didn't bet)
Seat 4: Zoryin folded before Flop (didn't bet)
Seat 5: mikrethor folded on the Flop
Seat 6: tamichebob (button) folded before Flop (didn't bet)



PokerStars Hand #109566093925:  Hold'em No Limit (€0.01/€0.02 EUR) - 2014/01/04 13:40:25 CET [2014/01/04 7:40:25 ET]
Table 'Ambrosia III' 6-max Seat #1 is the button
Seat 1: DoBrazil (€2.18 in chips) 
Seat 2: thierryjc11 (€0.87 in chips) 
Seat 3: chaim33 (€3.49 in chips) 
Seat 4: Zoryin (€2.07 in chips) 
Seat 5: mikrethor (€2.23 in chips) 
Seat 6: tamichebob (€1.41 in chips) 
thierryjc11: posts small blind €0.01
chaim33: posts big blind €0.02
*** HOLE CARDS ***
Dealt to mikrethor [8s 9d]
Zoryin: folds 
mikrethor: calls €0.02
tamichebob: folds 
DoBrazil: folds 
thierryjc11: calls €0.01
chaim33: checks 
*** FLOP *** [4h Qs Qc]
thierryjc11: bets €0.02
chaim33: folds 
mikrethor: folds 
Uncalled bet (€0.02) returned to thierryjc11
thierryjc11 collected €0.06 from pot
thierryjc11: doesn't show hand 
*** SUMMARY ***
Total pot €0.06 | Rake €0 
Board [4h Qs Qc]
Seat 1: DoBrazil (button) folded before Flop (didn't bet)
Seat 2: thierryjc11 (small blind) collected (€0.06)
Seat 3: chaim33 (big blind) folded on the Flop
Seat 4: Zoryin folded before Flop (didn't bet)
Seat 5: mikrethor folded on the Flop
Seat 6: tamichebob folded before Flop (didn't bet)



PokerStars Hand #109566105972:  Hold'em No Limit (€0.01/€0.02 EUR) - 2014/01/04 13:40:44 CET [2014/01/04 7:40:44 ET]
Table 'Ambrosia III' 6-max Seat #2 is the button
Seat 1: DoBrazil (€2.18 in chips) 
Seat 2: thierryjc11 (€0.91 in chips) 
Seat 3: chaim33 (€3.47 in chips) 
Seat 4: Zoryin (€2.07 in chips) 
Seat 5: mikrethor (€2.21 in chips) 
Seat 6: tamichebob (€1.41 in chips) 
chaim33: posts small blind €0.01
Zoryin: posts big blind €0.02
*** HOLE CARDS ***
Dealt to mikrethor [Qs 9c]
mikrethor: folds 
tamichebob: calls €0.02
DoBrazil: folds 
thierryjc11: calls €0.02
chaim33: folds 
Zoryin: checks 
*** FLOP *** [Qd Kc 4d]
Zoryin: checks 
tamichebob: checks 
thierryjc11: bets €0.06
Zoryin: folds 
tamichebob: calls €0.06
*** TURN *** [Qd Kc 4d] [Ah]
tamichebob: checks 
thierryjc11: checks 
*** RIVER *** [Qd Kc 4d Ah] [As]
tamichebob: bets €0.08
thierryjc11: folds 
Uncalled bet (€0.08) returned to tamichebob
tamichebob collected €0.18 from pot
tamichebob: doesn't show hand 
*** SUMMARY ***
Total pot €0.19 | Rake €0.01 
Board [Qd Kc 4d Ah As]
Seat 1: DoBrazil folded before Flop (didn't bet)
Seat 2: thierryjc11 (button) folded on the River
Seat 3: chaim33 (small blind) folded before Flop
Seat 4: Zoryin (big blind) folded on the Flop
Seat 5: mikrethor folded before Flop (didn't bet)
Seat 6: tamichebob collected (€0.18)



PokerStars Hand #109566139332:  Hold'em No Limit (€0.01/€0.02 EUR) - 2014/01/04 13:41:36 CET [2014/01/04 7:41:36 ET]
Table 'Ambrosia III' 6-max Seat #3 is the button
Seat 1: DoBrazil (€2.18 in chips) 
Seat 2: thierryjc11 (€0.83 in chips) 
Seat 3: chaim33 (€3.46 in chips) 
Seat 4: Zoryin (€2.05 in chips) 
Seat 5: mikrethor (€2.21 in chips) 
Seat 6: tamichebob (€1.51 in chips) 
Zoryin: posts small blind €0.01
mikrethor: posts big blind €0.02
*** HOLE CARDS ***
Dealt to mikrethor [8d 9s]
tamichebob: folds 
DoBrazil: folds 
thierryjc11: calls €0.02
chaim33: folds 
Zoryin: folds 
mikrethor: checks 
*** FLOP *** [3s Ts 7s]
mikrethor: bets €0.04
thierryjc11: calls €0.04
*** TURN *** [3s Ts 7s] [2h]
mikrethor: bets €0.06
thierryjc11: raises €0.06 to €0.12
mikrethor: calls €0.06
*** RIVER *** [3s Ts 7s 2h] [As]
mikrethor: bets €0.16
thierryjc11: calls €0.16
*** SHOW DOWN ***
mikrethor: shows [8d 9s] (a flush, Ace high)
thierryjc11: shows [4s Js] (a flush, Ace high - Jack higher)
thierryjc11 collected €0.65 from pot
*** SUMMARY ***
Total pot €0.69 | Rake €0.04 
Board [3s Ts 7s 2h As]
Seat 1: DoBrazil folded before Flop (didn't bet)
Seat 2: thierryjc11 showed [4s Js] and won (€0.65) with a flush, Ace high
Seat 3: chaim33 (button) folded before Flop (didn't bet)
Seat 4: Zoryin (small blind) folded before Flop
Seat 5: mikrethor (big blind) showed [8d 9s] and lost with a flush, Ace high
Seat 6: tamichebob folded before Flop (didn't bet)



PokerStars Hand #109566160589:  Hold'em No Limit (€0.01/€0.02 EUR) - 2014/01/04 13:42:10 CET [2014/01/04 7:42:10 ET]
Table 'Ambrosia III' 6-max Seat #4 is the button
Seat 1: DoBrazil (€2.18 in chips) 
Seat 2: thierryjc11 (€1.14 in chips) 
Seat 3: chaim33 (€3.46 in chips) 
Seat 4: Zoryin (€2.04 in chips) 
Seat 5: mikrethor (€1.87 in chips) 
Seat 6: tamichebob (€1.51 in chips) 
mikrethor: posts small blind €0.01
tamichebob: posts big blind €0.02
*** HOLE CARDS ***
Dealt to mikrethor [7c Jh]
DoBrazil: folds 
thierryjc11: calls €0.02
chaim33: folds 
Zoryin: folds 
mikrethor: folds 
tamichebob: checks 
*** FLOP *** [9s Kh Td]
tamichebob: checks 
thierryjc11: bets €0.04
tamichebob: folds 
Uncalled bet (€0.04) returned to thierryjc11
thierryjc11 collected €0.05 from pot
thierryjc11: doesn't show hand 
*** SUMMARY ***
Total pot €0.05 | Rake €0 
Board [9s Kh Td]
Seat 1: DoBrazil folded before Flop (didn't bet)
Seat 2: thierryjc11 collected (€0.05)
Seat 3: chaim33 folded before Flop (didn't bet)
Seat 4: Zoryin (button) folded before Flop (didn't bet)
Seat 5: mikrethor (small blind) folded before Flop
Seat 6: tamichebob (big blind) folded on the Flop



PokerStars Hand #109566182271:  Hold'em No Limit (€0.01/€0.02 EUR) - 2014/01/04 13:42:44 CET [2014/01/04 7:42:44 ET]
Table 'Ambrosia III' 6-max Seat #5 is the button
Seat 1: DoBrazil (€2.18 in chips) 
Seat 2: thierryjc11 (€1.17 in chips) 
Seat 3: chaim33 (€3.46 in chips) 
Seat 4: Zoryin (€2.04 in chips) 
Seat 5: mikrethor (€1.86 in chips) 
Seat 6: tamichebob (€1.49 in chips) 
tamichebob: posts small blind €0.01
DoBrazil: posts big blind €0.02
*** HOLE CARDS ***
Dealt to mikrethor [Kh Td]
thierryjc11: calls €0.02
chaim33: folds 
Zoryin: folds 
mikrethor: raises €0.08 to €0.10
tamichebob: folds 
DoBrazil: folds 
thierryjc11: folds 
Uncalled bet (€0.08) returned to mikrethor
mikrethor collected €0.07 from pot
mikrethor: doesn't show hand 
*** SUMMARY ***
Total pot €0.07 | Rake €0 
Seat 1: DoBrazil (big blind) folded before Flop
Seat 2: thierryjc11 folded before Flop
Seat 3: chaim33 folded before Flop (didn't bet)
Seat 4: Zoryin folded before Flop (didn't bet)
Seat 5: mikrethor (button) collected (€0.07)
Seat 6: tamichebob (small blind) folded before Flop



PokerStars Hand #109566197148:  Hold'em No Limit (€0.01/€0.02 EUR) - 2014/01/04 13:43:07 CET [2014/01/04 7:43:07 ET]
Table 'Ambrosia III' 6-max Seat #6 is the button
Seat 1: DoBrazil (€2.16 in chips) 
Seat 2: thierryjc11 (€1.15 in chips) 
Seat 3: chaim33 (€3.46 in chips) 
Seat 4: Zoryin (€2.04 in chips) 
Seat 5: mikrethor (€1.91 in chips) 
Seat 6: tamichebob (€1.48 in chips) 
DoBrazil: posts small blind €0.01
thierryjc11: posts big blind €0.02
*** HOLE CARDS ***
Dealt to mikrethor [3c Ks]
chaim33: folds 
Zoryin: folds 
mikrethor: folds 
tamichebob: folds 
DoBrazil: folds 
Uncalled bet (€0.01) returned to thierryjc11
thierryjc11 collected €0.02 from pot
thierryjc11: doesn't show hand 
*** SUMMARY ***
Total pot €0.02 | Rake €0 
Seat 1: DoBrazil (small blind) folded before Flop
Seat 2: thierryjc11 (big blind) collected (€0.02)
Seat 3: chaim33 folded before Flop (didn't bet)
Seat 4: Zoryin folded before Flop (didn't bet)
Seat 5: mikrethor folded before Flop (didn't bet)
Seat 6: tamichebob (button) folded before Flop (didn't bet)



PokerStars Hand #109566205608:  Hold'em No Limit (€0.01/€0.02 EUR) - 2014/01/04 13:43:21 CET [2014/01/04 7:43:21 ET]
Table 'Ambrosia III' 6-max Seat #1 is the button
Seat 1: DoBrazil (€2.15 in chips) 
Seat 2: thierryjc11 (€1.16 in chips) 
Seat 3: chaim33 (€3.46 in chips) 
Seat 4: Zoryin (€2.04 in chips) 
Seat 5: mikrethor (€1.91 in chips) 
Seat 6: tamichebob (€1.48 in chips) 
thierryjc11: posts small blind €0.01
chaim33: posts big blind €0.02
*** HOLE CARDS ***
Dealt to mikrethor [Ts Jc]
Zoryin: folds 
mikrethor: calls €0.02
tamichebob: folds 
DoBrazil: folds 
thierryjc11: calls €0.01
chaim33: checks 
*** FLOP *** [5h Qs 5s]
thierryjc11: bets €0.02
chaim33: folds 
mikrethor: folds 
Uncalled bet (€0.02) returned to thierryjc11
thierryjc11 collected €0.06 from pot
thierryjc11: doesn't show hand 
*** SUMMARY ***
Total pot €0.06 | Rake €0 
Board [5h Qs 5s]
Seat 1: DoBrazil (button) folded before Flop (didn't bet)
Seat 2: thierryjc11 (small blind) collected (€0.06)
Seat 3: chaim33 (big blind) folded on the Flop
Seat 4: Zoryin folded before Flop (didn't bet)
Seat 5: mikrethor folded on the Flop
Seat 6: tamichebob folded before Flop (didn't bet)



PokerStars Hand #109566219749:  Hold'em No Limit (€0.01/€0.02 EUR) - 2014/01/04 13:43:43 CET [2014/01/04 7:43:43 ET]
Table 'Ambrosia III' 6-max Seat #2 is the button
Seat 1: DoBrazil (€2.15 in chips) 
Seat 2: thierryjc11 (€1.20 in chips) 
Seat 3: chaim33 (€3.44 in chips) 
Seat 4: Zoryin (€2.04 in chips) 
Seat 5: mikrethor (€1.89 in chips) 
Seat 6: tamichebob (€1.48 in chips) 
chaim33: posts small blind €0.01
Zoryin: posts big blind €0.02
*** HOLE CARDS ***
Dealt to mikrethor [8s 6s]
mikrethor: folds 
tamichebob: folds 
DoBrazil: folds 
thierryjc11: calls €0.02
chaim33: folds 
Zoryin: checks 
*** FLOP *** [9h 9c 5d]
Zoryin: checks 
thierryjc11: bets €0.04
Zoryin: folds 
Uncalled bet (€0.04) returned to thierryjc11
thierryjc11 collected €0.05 from pot
thierryjc11: doesn't show hand 
*** SUMMARY ***
Total pot €0.05 | Rake €0 
Board [9h 9c 5d]
Seat 1: DoBrazil folded before Flop (didn't bet)
Seat 2: thierryjc11 (button) collected (€0.05)
Seat 3: chaim33 (small blind) folded before Flop
Seat 4: Zoryin (big blind) folded on the Flop
Seat 5: mikrethor folded before Flop (didn't bet)
Seat 6: tamichebob folded before Flop (didn't bet)



PokerStars Hand #109566238403:  Hold'em No Limit (€0.01/€0.02 EUR) - 2014/01/04 13:44:12 CET [2014/01/04 7:44:12 ET]
Table 'Ambrosia III' 6-max Seat #3 is the button
Seat 1: DoBrazil (€2.15 in chips) 
Seat 2: thierryjc11 (€1.23 in chips) 
Seat 3: chaim33 (€3.43 in chips) 
Seat 4: Zoryin (€2.02 in chips) 
Seat 5: mikrethor (€1.89 in chips) 
Seat 6: tamichebob (€1.48 in chips) 
Zoryin: posts small blind €0.01
mikrethor: posts big blind €0.02
*** HOLE CARDS ***
Dealt to mikrethor [9d 3h]
tamichebob: folds 
DoBrazil: folds 
thierryjc11: calls €0.02
chaim33: raises €0.08 to €0.10
Zoryin: calls €0.09
mikrethor: folds 
thierryjc11: folds 
*** FLOP *** [4d As Js]
Zoryin: checks 
chaim33: bets €0.14
Zoryin: folds 
Uncalled bet (€0.14) returned to chaim33
chaim33 collected €0.23 from pot
*** SUMMARY ***
Total pot €0.24 | Rake €0.01 
Board [4d As Js]
Seat 1: DoBrazil folded before Flop (didn't bet)
Seat 2: thierryjc11 folded before Flop
Seat 3: chaim33 (button) collected (€0.23)
Seat 4: Zoryin (small blind) folded on the Flop
Seat 5: mikrethor (big blind) folded before Flop
Seat 6: tamichebob folded before Flop (didn't bet)



PokerStars Hand #109566259970:  Hold'em No Limit (€0.01/€0.02 EUR) - 2014/01/04 13:44:46 CET [2014/01/04 7:44:46 ET]
Table 'Ambrosia III' 6-max Seat #4 is the button
Seat 1: DoBrazil (€2.15 in chips) 
Seat 2: thierryjc11 (€1.21 in chips) 
Seat 3: chaim33 (€3.56 in chips) 
Seat 4: Zoryin (€2 in chips) 
Seat 5: mikrethor (€1.87 in chips) 
mikrethor: posts small blind €0.01
DoBrazil: posts big blind €0.02
*** HOLE CARDS ***
Dealt to mikrethor [7s 3s]
tamichebob is disconnected 
thierryjc11: folds 
chaim33: folds 
Zoryin: folds 
mikrethor: raises €0.04 to €0.06
DoBrazil: calls €0.04
*** FLOP *** [3d 5d 5h]
mikrethor: bets €0.10
DoBrazil: folds 
Uncalled bet (€0.10) returned to mikrethor
mikrethor collected €0.11 from pot
mikrethor: doesn't show hand 
*** SUMMARY ***
Total pot €0.12 | Rake €0.01 
Board [3d 5d 5h]
Seat 1: DoBrazil (big blind) folded on the Flop
Seat 2: thierryjc11 folded before Flop (didn't bet)
Seat 3: chaim33 folded before Flop (didn't bet)
Seat 4: Zoryin (button) folded before Flop (didn't bet)
Seat 5: mikrethor (small blind) collected (€0.11)



PokerStars Hand #109566272737:  Hold'em No Limit (€0.01/€0.02 EUR) - 2014/01/04 13:45:06 CET [2014/01/04 7:45:06 ET]
Table 'Ambrosia III' 6-max Seat #5 is the button
Seat 1: DoBrazil (€2.09 in chips) 
Seat 2: thierryjc11 (€1.21 in chips) 
Seat 3: chaim33 (€3.56 in chips) 
Seat 4: Zoryin (€2 in chips) 
Seat 5: mikrethor (€1.92 in chips) 
DoBrazil: posts small blind €0.01
thierryjc11: posts big blind €0.02
*** HOLE CARDS ***
Dealt to mikrethor [Js 3s]
chaim33: folds 
Zoryin: raises €0.06 to €0.08
mikrethor: folds 
DoBrazil: folds 
thierryjc11: calls €0.06
*** FLOP *** [5h 6d 5c]
thierryjc11: checks 
Zoryin: bets €0.12
thierryjc11: folds 
Uncalled bet (€0.12) returned to Zoryin
Zoryin collected €0.16 from pot
Zoryin: doesn't show hand 
*** SUMMARY ***
Total pot €0.17 | Rake €0.01 
Board [5h 6d 5c]
Seat 1: DoBrazil (small blind) folded before Flop
Seat 2: thierryjc11 (big blind) folded on the Flop
Seat 3: chaim33 folded before Flop (didn't bet)
Seat 4: Zoryin collected (€0.16)
Seat 5: mikrethor (button) folded before Flop (didn't bet)



PokerStars Hand #109566286624:  Hold'em No Limit (€0.01/€0.02 EUR) - 2014/01/04 13:45:28 CET [2014/01/04 7:45:28 ET]
Table 'Ambrosia III' 6-max Seat #1 is the button
Seat 1: DoBrazil (€2.08 in chips) 
Seat 2: thierryjc11 (€1.13 in chips) 
Seat 3: chaim33 (€3.56 in chips) 
Seat 4: Zoryin (€2.08 in chips) 
Seat 5: mikrethor (€1.92 in chips) 
Seat 6: tamichebob (€1.48 in chips) 
thierryjc11: posts small blind €0.01
chaim33: posts big blind €0.02
tamichebob: posts small & big blinds €0.03
*** HOLE CARDS ***
Dealt to mikrethor [8c Js]
Zoryin: raises €0.06 to €0.08
mikrethor: folds 
tamichebob: folds 
DoBrazil: folds 
thierryjc11: folds 
chaim33: folds 
Uncalled bet (€0.06) returned to Zoryin
Zoryin collected €0.08 from pot
*** SUMMARY ***
Total pot €0.08 | Rake €0 
Seat 1: DoBrazil (button) folded before Flop (didn't bet)
Seat 2: thierryjc11 (small blind) folded before Flop
Seat 3: chaim33 (big blind) folded before Flop
Seat 4: Zoryin collected (€0.08)
Seat 5: mikrethor folded before Flop (didn't bet)
Seat 6: tamichebob folded before Flop



PokerStars Hand #109566298339:  Hold'em No Limit (€0.01/€0.02 EUR) - 2014/01/04 13:45:47 CET [2014/01/04 7:45:47 ET]
Table 'Ambrosia III' 6-max Seat #2 is the button
Seat 1: DoBrazil (€2.08 in chips) 
Seat 2: thierryjc11 (€1.12 in chips) 
Seat 3: chaim33 (€3.54 in chips) 
Seat 4: Zoryin (€2.14 in chips) 
Seat 5: mikrethor (€1.92 in chips) 
Seat 6: tamichebob (€1.45 in chips) 
chaim33: posts small blind €0.01
Zoryin: posts big blind €0.02
*** HOLE CARDS ***
Dealt to mikrethor [6d Tc]
mikrethor: folds 
tamichebob: calls €0.02
DoBrazil: raises €0.08 to €0.10
thierryjc11: folds 
chaim33: raises €0.20 to €0.30
Zoryin: folds 
tamichebob: folds 
DoBrazil: calls €0.20
*** FLOP *** [Jh 5h Ks]
chaim33: bets €0.60
DoBrazil: folds 
Uncalled bet (€0.60) returned to chaim33
chaim33 collected €0.60 from pot
*** SUMMARY ***
Total pot €0.64 | Rake €0.04 
Board [Jh 5h Ks]
Seat 1: DoBrazil folded on the Flop
Seat 2: thierryjc11 (button) folded before Flop (didn't bet)
Seat 3: chaim33 (small blind) collected (€0.60)
Seat 4: Zoryin (big blind) folded before Flop
Seat 5: mikrethor folded before Flop (didn't bet)
Seat 6: tamichebob folded before Flop



PokerStars Hand #109566322077:  Hold'em No Limit (€0.01/€0.02 EUR) - 2014/01/04 13:46:24 CET [2014/01/04 7:46:24 ET]
Table 'Ambrosia III' 6-max Seat #3 is the button
Seat 1: DoBrazil (€2 in chips) 
Seat 2: thierryjc11 (€1.12 in chips) 
Seat 3: chaim33 (€3.84 in chips) 
Seat 4: Zoryin (€2.12 in chips) 
Seat 5: mikrethor (€1.92 in chips) 
Seat 6: tamichebob (€1.43 in chips) 
Zoryin: posts small blind €0.01
mikrethor: posts big blind €0.02
*** HOLE CARDS ***
Dealt to mikrethor [9c Qs]
tamichebob: folds 
DoBrazil: folds 
thierryjc11: folds 
chaim33: folds 
Zoryin: folds 
Uncalled bet (€0.01) returned to mikrethor
mikrethor collected €0.02 from pot
mikrethor: doesn't show hand 
*** SUMMARY ***
Total pot €0.02 | Rake €0 
Seat 1: DoBrazil folded before Flop (didn't bet)
Seat 2: thierryjc11 folded before Flop (didn't bet)
Seat 3: chaim33 (button) folded before Flop (didn't bet)
Seat 4: Zoryin (small blind) folded before Flop
Seat 5: mikrethor (big blind) collected (€0.02)
Seat 6: tamichebob folded before Flop (didn't bet)



PokerStars Hand #109566334105:  Hold'em No Limit (€0.01/€0.02 EUR) - 2014/01/04 13:46:43 CET [2014/01/04 7:46:43 ET]
Table 'Ambrosia III' 6-max Seat #4 is the button
Seat 1: DoBrazil (€2 in chips) 
Seat 2: thierryjc11 (€1.12 in chips) 
Seat 3: chaim33 (€3.84 in chips) 
Seat 4: Zoryin (€2.11 in chips) 
Seat 5: mikrethor (€1.93 in chips) 
Seat 6: tamichebob (€1.43 in chips) 
mikrethor: posts small blind €0.01
tamichebob: posts big blind €0.02
*** HOLE CARDS ***
Dealt to mikrethor [9d 6h]
DoBrazil: folds 
thierryjc11: calls €0.02
chaim33: raises €0.08 to €0.10
Zoryin: folds 
mikrethor: folds 
tamichebob: folds 
thierryjc11: folds 
Uncalled bet (€0.08) returned to chaim33
chaim33 collected €0.07 from pot
*** SUMMARY ***
Total pot €0.07 | Rake €0 
Seat 1: DoBrazil folded before Flop (didn't bet)
Seat 2: thierryjc11 folded before Flop
Seat 3: chaim33 collected (€0.07)
Seat 4: Zoryin (button) folded before Flop (didn't bet)
Seat 5: mikrethor (small blind) folded before Flop
Seat 6: tamichebob (big blind) folded before Flop



PokerStars Hand #109566346430:  Hold'em No Limit (€0.01/€0.02 EUR) - 2014/01/04 13:47:03 CET [2014/01/04 7:47:03 ET]
Table 'Ambrosia III' 6-max Seat #5 is the button
Seat 1: DoBrazil (€2 in chips) 
Seat 2: thierryjc11 (€1.10 in chips) 
Seat 3: chaim33 (€3.89 in chips) 
Seat 4: Zoryin (€2.11 in chips) 
Seat 5: mikrethor (€1.92 in chips) 
Seat 6: tamichebob (€1.41 in chips) 
tamichebob: posts small blind €0.01
DoBrazil: posts big blind €0.02
*** HOLE CARDS ***
Dealt to mikrethor [Jc 4c]
thierryjc11: folds 
chaim33: folds 
Zoryin: folds 
mikrethor: raises €0.04 to €0.06
chaim33 leaves the table
tamichebob: calls €0.05
DoBrazil: folds 
*** FLOP *** [5c 6h 9s]
tamichebob: checks 
mikrethor: bets €0.12
tamichebob: folds 
Uncalled bet (€0.12) returned to mikrethor
mikrethor collected €0.13 from pot
mikrethor: doesn't show hand 
*** SUMMARY ***
Total pot €0.14 | Rake €0.01 
Board [5c 6h 9s]
Seat 1: DoBrazil (big blind) folded before Flop
Seat 2: thierryjc11 folded before Flop (didn't bet)
Seat 3: chaim33 folded before Flop (didn't bet)
Seat 4: Zoryin folded before Flop (didn't bet)
Seat 5: mikrethor (button) collected (€0.13)
Seat 6: tamichebob (small blind) folded on the Flop



PokerStars Hand #109566370747:  Hold'em No Limit (€0.01/€0.02 EUR) - 2014/01/04 13:47:41 CET [2014/01/04 7:47:41 ET]
Table 'Ambrosia III' 6-max Seat #6 is the button
Seat 1: DoBrazil (€1.98 in chips) 
Seat 2: thierryjc11 (€1.10 in chips) 
Seat 4: Zoryin (€2.11 in chips) 
Seat 5: mikrethor (€1.99 in chips) 
Seat 6: tamichebob (€1.35 in chips) 
DoBrazil: posts small blind €0.01
thierryjc11: posts big blind €0.02
*** HOLE CARDS ***
Dealt to mikrethor [8c Kh]
Zoryin: folds 
mikrethor: folds 
tamichebob: folds 
DoBrazil: folds 
Uncalled bet (€0.01) returned to thierryjc11
thierryjc11 collected €0.02 from pot
thierryjc11: doesn't show hand 
*** SUMMARY ***
Total pot €0.02 | Rake €0 
Seat 1: DoBrazil (small blind) folded before Flop
Seat 2: thierryjc11 (big blind) collected (€0.02)
Seat 4: Zoryin folded before Flop (didn't bet)
Seat 5: mikrethor folded before Flop (didn't bet)
Seat 6: tamichebob (button) folded before Flop (didn't bet)



PokerStars Hand #109566384886:  Hold'em No Limit (€0.01/€0.02 EUR) - 2014/01/04 13:48:04 CET [2014/01/04 7:48:04 ET]
Table 'Ambrosia III' 6-max Seat #1 is the button
Seat 1: DoBrazil (€1.97 in chips) 
Seat 2: thierryjc11 (€1.11 in chips) 
Seat 4: Zoryin (€2.11 in chips) 
Seat 5: mikrethor (€1.99 in chips) 
Seat 6: tamichebob (€1.35 in chips) 
thierryjc11: posts small blind €0.01
Zoryin: posts big blind €0.02
*** HOLE CARDS ***
Dealt to mikrethor [9c Qs]
mikrethor: folds 
tamichebob: calls €0.02
DoBrazil: folds 
thierryjc11: calls €0.01
Zoryin: checks 
*** FLOP *** [Jd 7h Ad]
thierryjc11: bets €0.02
Zoryin: folds 
tamichebob: calls €0.02
*** TURN *** [Jd 7h Ad] [6h]
thierryjc11: bets €0.02
tamichebob: calls €0.02
*** RIVER *** [Jd 7h Ad 6h] [Kc]
thierryjc11: bets €0.06
tamichebob: calls €0.06
*** SHOW DOWN ***
thierryjc11: shows [Kd 8h] (a pair of Kings)
tamichebob: shows [As Qd] (a pair of Aces)
tamichebob collected €0.24 from pot
pretinu2a joins the table at seat #3 
*** SUMMARY ***
Total pot €0.26 | Rake €0.02 
Board [Jd 7h Ad 6h Kc]
Seat 1: DoBrazil (button) folded before Flop (didn't bet)
Seat 2: thierryjc11 (small blind) showed [Kd 8h] and lost with a pair of Kings
Seat 4: Zoryin (big blind) folded on the Flop
Seat 5: mikrethor folded before Flop (didn't bet)
Seat 6: tamichebob showed [As Qd] and won (€0.24) with a pair of Aces



PokerStars Hand #109566423667:  Hold'em No Limit (€0.01/€0.02 EUR) - 2014/01/04 13:49:05 CET [2014/01/04 7:49:05 ET]
Table 'Ambrosia III' 6-max Seat #2 is the button
Seat 1: DoBrazil (€1.97 in chips) 
Seat 2: thierryjc11 (€0.99 in chips) 
Seat 4: Zoryin (€2.09 in chips) 
Seat 5: mikrethor (€1.99 in chips) 
Seat 6: tamichebob (€1.47 in chips) 
pretinu2a will be allowed to play after the button
Zoryin: posts small blind €0.01
mikrethor: posts big blind €0.02
*** HOLE CARDS ***
Dealt to mikrethor [7c Ad]
tamichebob: calls €0.02
DoBrazil: folds 
thierryjc11: calls €0.02
Zoryin: calls €0.01
mikrethor: checks 
*** FLOP *** [3c 2d Js]
Zoryin: checks 
mikrethor: checks 
tamichebob: checks 
thierryjc11: bets €0.04
Zoryin: calls €0.04
mikrethor: folds 
tamichebob: calls €0.04
*** TURN *** [3c 2d Js] [7d]
Zoryin: checks 
tamichebob: checks 
thierryjc11: checks 
*** RIVER *** [3c 2d Js 7d] [3h]
Zoryin: checks 
tamichebob: checks 
thierryjc11: bets €0.08
Zoryin: calls €0.08
tamichebob: folds 
*** SHOW DOWN ***
thierryjc11: shows [Th 3d] (three of a kind, Threes)
Zoryin: mucks hand 
thierryjc11 collected €0.34 from pot
*** SUMMARY ***
Total pot €0.36 | Rake €0.02 
Board [3c 2d Js 7d 3h]
Seat 1: DoBrazil folded before Flop (didn't bet)
Seat 2: thierryjc11 (button) showed [Th 3d] and won (€0.34) with three of a kind, Threes
Seat 4: Zoryin (small blind) mucked [9d 9c]
Seat 5: mikrethor (big blind) folded on the Flop
Seat 6: tamichebob folded on the River



PokerStars Hand #109566476199:  Hold'em No Limit (€0.01/€0.02 EUR) - 2014/01/04 13:50:28 CET [2014/01/04 7:50:28 ET]
Table 'Ambrosia III' 6-max Seat #4 is the button
Seat 1: DoBrazil (€1.97 in chips) 
Seat 2: thierryjc11 (€1.19 in chips) 
Seat 3: pretinu2a (€1.60 in chips) 
Seat 4: Zoryin (€2 in chips) 
Seat 5: mikrethor (€1.97 in chips) 
Seat 6: tamichebob (€1.41 in chips) 
mikrethor: posts small blind €0.01
tamichebob: posts big blind €0.02
pretinu2a: posts big blind €0.02
*** HOLE CARDS ***
Dealt to mikrethor [5d Ac]
DoBrazil: folds 
thierryjc11: calls €0.02
pretinu2a: checks 
Zoryin: folds 
mikrethor: raises €0.08 to €0.10
tamichebob: folds 
thierryjc11: folds 
pretinu2a: folds 
Uncalled bet (€0.08) returned to mikrethor
mikrethor collected €0.08 from pot
mikrethor: doesn't show hand 
*** SUMMARY ***
Total pot €0.08 | Rake €0 
Seat 1: DoBrazil folded before Flop (didn't bet)
Seat 2: thierryjc11 folded before Flop
Seat 3: pretinu2a folded before Flop
Seat 4: Zoryin (button) folded before Flop (didn't bet)
Seat 5: mikrethor (small blind) collected (€0.08)
Seat 6: tamichebob (big blind) folded before Flop



PokerStars Hand #109566506047:  Hold'em No Limit (€0.01/€0.02 EUR) - 2014/01/04 13:51:15 CET [2014/01/04 7:51:15 ET]
Table 'Ambrosia III' 6-max Seat #5 is the button
Seat 1: DoBrazil (€1.97 in chips) 
Seat 2: thierryjc11 (€1.17 in chips) 
Seat 3: pretinu2a (€1.58 in chips) 
Seat 4: Zoryin (€2 in chips) 
Seat 5: mikrethor (€2.03 in chips) 
Seat 6: tamichebob (€1.39 in chips) 
tamichebob: posts small blind €0.01
DoBrazil: posts big blind €0.02
*** HOLE CARDS ***
Dealt to mikrethor [4c 5h]
thierryjc11: calls €0.02
pretinu2a: calls €0.02
Zoryin: folds 
mikrethor: folds 
tamichebob: calls €0.01
DoBrazil: checks 
*** FLOP *** [8c 3c 6c]
tamichebob: checks 
DoBrazil: checks 
thierryjc11: bets €0.02
pretinu2a: calls €0.02
tamichebob: folds 
DoBrazil: folds 
*** TURN *** [8c 3c 6c] [Tc]
thierryjc11: bets €0.02
pretinu2a: calls €0.02
*** RIVER *** [8c 3c 6c Tc] [9s]
thierryjc11: bets €0.04
pretinu2a: raises €0.04 to €0.08
thierryjc11: folds 
Uncalled bet (€0.04) returned to pretinu2a
pretinu2a collected €0.23 from pot
pretinu2a: doesn't show hand 
*** SUMMARY ***
Total pot €0.24 | Rake €0.01 
Board [8c 3c 6c Tc 9s]
Seat 1: DoBrazil (big blind) folded on the Flop
Seat 2: thierryjc11 folded on the River
Seat 3: pretinu2a collected (€0.23)
Seat 4: Zoryin folded before Flop (didn't bet)
Seat 5: mikrethor (button) folded before Flop (didn't bet)
Seat 6: tamichebob (small blind) folded on the Flop



PokerStars Hand #109566547405:  Hold'em No Limit (€0.01/€0.02 EUR) - 2014/01/04 13:52:19 CET [2014/01/04 7:52:19 ET]
Table 'Ambrosia III' 6-max Seat #6 is the button
Seat 1: DoBrazil (€1.95 in chips) 
Seat 2: thierryjc11 (€1.07 in chips) 
Seat 3: pretinu2a (€1.71 in chips) 
Seat 4: Zoryin (€2 in chips) 
Seat 5: mikrethor (€2.03 in chips) 
Seat 6: tamichebob (€1.37 in chips) 
DoBrazil: posts small blind €0.01
thierryjc11: posts big blind €0.02
*** HOLE CARDS ***
Dealt to mikrethor [2h 3s]
pretinu2a: folds 
Zoryin: folds 
mikrethor: folds 
tamichebob: raises €0.04 to €0.06
DoBrazil: folds 
thierryjc11: folds 
Uncalled bet (€0.04) returned to tamichebob
tamichebob collected €0.05 from pot
tamichebob: doesn't show hand 
*** SUMMARY ***
Total pot €0.05 | Rake €0 
Seat 1: DoBrazil (small blind) folded before Flop
Seat 2: thierryjc11 (big blind) folded before Flop
Seat 3: pretinu2a folded before Flop (didn't bet)
Seat 4: Zoryin folded before Flop (didn't bet)
Seat 5: mikrethor folded before Flop (didn't bet)
Seat 6: tamichebob (button) collected (€0.05)



PokerStars Hand #109566558036:  Hold'em No Limit (€0.01/€0.02 EUR) - 2014/01/04 13:52:36 CET [2014/01/04 7:52:36 ET]
Table 'Ambrosia III' 6-max Seat #1 is the button
Seat 1: DoBrazil (€1.94 in chips) 
Seat 2: thierryjc11 (€1.05 in chips) 
Seat 3: pretinu2a (€1.71 in chips) 
Seat 4: Zoryin (€2 in chips) 
Seat 5: mikrethor (€2.03 in chips) 
Seat 6: tamichebob (€1.40 in chips) 
thierryjc11: posts small blind €0.01
pretinu2a: posts big blind €0.02
*** HOLE CARDS ***
Dealt to mikrethor [Qh 5c]
Zoryin: folds 
mikrethor: folds 
tamichebob: folds 
DoBrazil: folds 
thierryjc11: calls €0.01
pretinu2a: checks 
*** FLOP *** [7c Kd 8s]
thierryjc11: bets €0.04
pretinu2a: calls €0.04
*** TURN *** [7c Kd 8s] [7h]
thierryjc11: checks 
pretinu2a: bets €0.02
thierryjc11: calls €0.02
*** RIVER *** [7c Kd 8s 7h] [Th]
thierryjc11: checks 
pretinu2a: bets €0.12
thierryjc11: folds 
Uncalled bet (€0.12) returned to pretinu2a
pretinu2a collected €0.15 from pot
pretinu2a: doesn't show hand 
*** SUMMARY ***
Total pot €0.16 | Rake €0.01 
Board [7c Kd 8s 7h Th]
Seat 1: DoBrazil (button) folded before Flop (didn't bet)
Seat 2: thierryjc11 (small blind) folded on the River
Seat 3: pretinu2a (big blind) collected (€0.15)
Seat 4: Zoryin folded before Flop (didn't bet)
Seat 5: mikrethor folded before Flop (didn't bet)
Seat 6: tamichebob folded before Flop (didn't bet)



PokerStars Hand #109566585111:  Hold'em No Limit (€0.01/€0.02 EUR) - 2014/01/04 13:53:18 CET [2014/01/04 7:53:18 ET]
Table 'Ambrosia III' 6-max Seat #2 is the button
Seat 1: DoBrazil (€1.94 in chips) 
Seat 2: thierryjc11 (€0.97 in chips) 
Seat 3: pretinu2a (€1.78 in chips) 
Seat 4: Zoryin (€2 in chips) 
Seat 5: mikrethor (€2.03 in chips) 
Seat 6: tamichebob (€1.40 in chips) 
pretinu2a: posts small blind €0.01
Zoryin: posts big blind €0.02
*** HOLE CARDS ***
Dealt to mikrethor [7s Kc]
mikrethor: folds 
tamichebob: calls €0.02
DoBrazil: calls €0.02
thierryjc11: calls €0.02
pretinu2a: raises €0.02 to €0.04
Zoryin: calls €0.02
tamichebob: calls €0.02
DoBrazil: calls €0.02
thierryjc11: calls €0.02
*** FLOP *** [Qd 2h 8h]
pretinu2a: bets €0.02
Zoryin: calls €0.02
tamichebob: calls €0.02
DoBrazil: folds 
thierryjc11: calls €0.02
*** TURN *** [Qd 2h 8h] [Ac]
pretinu2a: bets €0.14
Zoryin: folds 
tamichebob: calls €0.14
thierryjc11: folds 
*** RIVER *** [Qd 2h 8h Ac] [7h]
pretinu2a: bets €0.16
tamichebob: calls €0.16
*** SHOW DOWN ***
pretinu2a: shows [Ks Qs] (a pair of Queens)
tamichebob: shows [2c Ah] (two pair, Aces and Deuces)
tamichebob collected €0.83 from pot
*** SUMMARY ***
Total pot €0.88 | Rake €0.05 
Board [Qd 2h 8h Ac 7h]
Seat 1: DoBrazil folded on the Flop
Seat 2: thierryjc11 (button) folded on the Turn
Seat 3: pretinu2a (small blind) showed [Ks Qs] and lost with a pair of Queens
Seat 4: Zoryin (big blind) folded on the Turn
Seat 5: mikrethor folded before Flop (didn't bet)
Seat 6: tamichebob showed [2c Ah] and won (€0.83) with two pair, Aces and Deuces



PokerStars Hand #109566638161:  Hold'em No Limit (€0.01/€0.02 EUR) - 2014/01/04 13:54:42 CET [2014/01/04 7:54:42 ET]
Table 'Ambrosia III' 6-max Seat #3 is the button
Seat 1: DoBrazil (€2 in chips) 
Seat 2: thierryjc11 (€0.91 in chips) 
Seat 3: pretinu2a (€1.42 in chips) 
Seat 4: Zoryin (€2 in chips) 
Seat 5: mikrethor (€2.03 in chips) 
Seat 6: tamichebob (€1.87 in chips) 
Zoryin: posts small blind €0.01
mikrethor: posts big blind €0.02
*** HOLE CARDS ***
Dealt to mikrethor [8d Qh]
tamichebob: folds 
DoBrazil: folds 
thierryjc11: calls €0.02
pretinu2a: calls €0.02
Zoryin: folds 
mikrethor: checks 
*** FLOP *** [Ks 8c 3d]
mikrethor: checks 
thierryjc11: bets €0.02
pretinu2a: raises €0.02 to €0.04
mikrethor: folds 
thierryjc11: calls €0.02
*** TURN *** [Ks 8c 3d] [5s]
thierryjc11: checks 
pretinu2a: bets €0.02
thierryjc11: calls €0.02
*** RIVER *** [Ks 8c 3d 5s] [6h]
thierryjc11: bets €0.06
pretinu2a: calls €0.06
*** SHOW DOWN ***
thierryjc11: shows [Td Jd] (high card King)
pretinu2a: shows [Kc Qc] (a pair of Kings)
pretinu2a collected €0.29 from pot
*** SUMMARY ***
Total pot €0.31 | Rake €0.02 
Board [Ks 8c 3d 5s 6h]
Seat 1: DoBrazil folded before Flop (didn't bet)
Seat 2: thierryjc11 showed [Td Jd] and lost with high card King
Seat 3: pretinu2a (button) showed [Kc Qc] and won (€0.29) with a pair of Kings
Seat 4: Zoryin (small blind) folded before Flop
Seat 5: mikrethor (big blind) folded on the Flop
Seat 6: tamichebob folded before Flop (didn't bet)



PokerStars Hand #109566673412:  Hold'em No Limit (€0.01/€0.02 EUR) - 2014/01/04 13:55:44 CET [2014/01/04 7:55:44 ET]
Table 'Ambrosia III' 6-max Seat #4 is the button
Seat 1: DoBrazil (€2 in chips) 
Seat 2: thierryjc11 (€0.77 in chips) 
Seat 3: pretinu2a (€1.57 in chips) 
Seat 4: Zoryin (€2 in chips) 
Seat 5: mikrethor (€2.01 in chips) 
Seat 6: tamichebob (€1.87 in chips) 
mikrethor: posts small blind €0.01
tamichebob: posts big blind €0.02
*** HOLE CARDS ***
Dealt to mikrethor [3d As]
DoBrazil: folds 
thierryjc11: calls €0.02
pretinu2a: folds 
Zoryin: raises €0.08 to €0.10
mikrethor: folds 
tamichebob: folds 
thierryjc11: calls €0.08
*** FLOP *** [5s Tc 7h]
thierryjc11: checks 
Zoryin: bets €0.16
thierryjc11: folds 
Uncalled bet (€0.16) returned to Zoryin
Zoryin collected €0.22 from pot
Zoryin: doesn't show hand 
*** SUMMARY ***
Total pot €0.23 | Rake €0.01 
Board [5s Tc 7h]
Seat 1: DoBrazil folded before Flop (didn't bet)
Seat 2: thierryjc11 folded on the Flop
Seat 3: pretinu2a folded before Flop (didn't bet)
Seat 4: Zoryin (button) collected (€0.22)
Seat 5: mikrethor (small blind) folded before Flop
Seat 6: tamichebob (big blind) folded before Flop



PokerStars Hand #109566690998:  Hold'em No Limit (€0.01/€0.02 EUR) - 2014/01/04 13:56:18 CET [2014/01/04 7:56:18 ET]
Table 'Ambrosia III' 6-max Seat #5 is the button
Seat 1: DoBrazil (€2 in chips) 
Seat 2: thierryjc11 (€0.67 in chips) 
Seat 3: pretinu2a (€1.57 in chips) 
Seat 4: Zoryin (€2.12 in chips) 
Seat 5: mikrethor (€2 in chips) 
Seat 6: tamichebob (€1.85 in chips) 
tamichebob: posts small blind €0.01
DoBrazil: posts big blind €0.02
*** HOLE CARDS ***
Dealt to mikrethor [Qh Ks]
thierryjc11: calls €0.02
pretinu2a: calls €0.02
Zoryin: raises €0.10 to €0.12
mikrethor: folds 
tamichebob: folds 
DoBrazil: folds 
thierryjc11: folds 
pretinu2a: folds 
Uncalled bet (€0.10) returned to Zoryin
Zoryin collected €0.09 from pot
Zoryin: doesn't show hand 
*** SUMMARY ***
Total pot €0.09 | Rake €0 
Seat 1: DoBrazil (big blind) folded before Flop
Seat 2: thierryjc11 folded before Flop
Seat 3: pretinu2a folded before Flop
Seat 4: Zoryin collected (€0.09)
Seat 5: mikrethor (button) folded before Flop (didn't bet)
Seat 6: tamichebob (small blind) folded before Flop



PokerStars Hand #109566705035:  Hold'em No Limit (€0.01/€0.02 EUR) - 2014/01/04 13:56:44 CET [2014/01/04 7:56:44 ET]
Table 'Ambrosia III' 6-max Seat #6 is the button
Seat 1: DoBrazil (€1.98 in chips) 
Seat 2: thierryjc11 (€0.65 in chips) 
Seat 3: pretinu2a (€1.55 in chips) 
Seat 4: Zoryin (€2.19 in chips) 
Seat 5: mikrethor (€2 in chips) 
Seat 6: tamichebob (€1.84 in chips) 
DoBrazil: posts small blind €0.01
thierryjc11: posts big blind €0.02
*** HOLE CARDS ***
Dealt to mikrethor [6s Qs]
pretinu2a: folds 
Zoryin: folds 
mikrethor: raises €0.06 to €0.08
tamichebob: folds 
DoBrazil: folds 
thierryjc11: folds 
Uncalled bet (€0.06) returned to mikrethor
mikrethor collected €0.05 from pot
mikrethor: doesn't show hand 
*** SUMMARY ***
Total pot €0.05 | Rake €0 
Seat 1: DoBrazil (small blind) folded before Flop
Seat 2: thierryjc11 (big blind) folded before Flop
Seat 3: pretinu2a folded before Flop (didn't bet)
Seat 4: Zoryin folded before Flop (didn't bet)
Seat 5: mikrethor collected (€0.05)
Seat 6: tamichebob (button) folded before Flop (didn't bet)



PokerStars Hand #109566714343:  Hold'em No Limit (€0.01/€0.02 EUR) - 2014/01/04 13:57:02 CET [2014/01/04 7:57:02 ET]
Table 'Ambrosia III' 6-max Seat #1 is the button
Seat 1: DoBrazil (€1.97 in chips) 
Seat 2: thierryjc11 (€0.63 in chips) 
Seat 3: pretinu2a (€1.55 in chips) 
Seat 4: Zoryin (€2.19 in chips) 
Seat 5: mikrethor (€2.03 in chips) 
Seat 6: tamichebob (€1.84 in chips) 
thierryjc11: posts small blind €0.01
pretinu2a: posts big blind €0.02
*** HOLE CARDS ***
Dealt to mikrethor [Ah Qc]
Zoryin: folds 
mikrethor: raises €0.06 to €0.08
tamichebob: folds 
DoBrazil: folds 
thierryjc11: folds 
pretinu2a: calls €0.06
*** FLOP *** [3d As Ts]
pretinu2a: checks 
mikrethor: bets €0.08
pretinu2a: folds 
Uncalled bet (€0.08) returned to mikrethor
mikrethor collected €0.16 from pot
mikrethor: doesn't show hand 
*** SUMMARY ***
Total pot €0.17 | Rake €0.01 
Board [3d As Ts]
Seat 1: DoBrazil (button) folded before Flop (didn't bet)
Seat 2: thierryjc11 (small blind) folded before Flop
Seat 3: pretinu2a (big blind) folded on the Flop
Seat 4: Zoryin folded before Flop (didn't bet)
Seat 5: mikrethor collected (€0.16)
Seat 6: tamichebob folded before Flop (didn't bet)



PokerStars Hand #109566734185:  Hold'em No Limit (€0.01/€0.02 EUR) - 2014/01/04 13:57:40 CET [2014/01/04 7:57:40 ET]
Table 'Ambrosia III' 6-max Seat #2 is the button
Seat 1: DoBrazil (€1.97 in chips) 
Seat 2: thierryjc11 (€0.62 in chips) 
Seat 3: pretinu2a (€1.47 in chips) 
Seat 4: Zoryin (€2.19 in chips) 
Seat 5: mikrethor (€2.11 in chips) 
Seat 6: tamichebob (€1.84 in chips) 
pretinu2a: posts small blind €0.01
Zoryin: posts big blind €0.02
*** HOLE CARDS ***
Dealt to mikrethor [9h 6h]
mikrethor: folds 
tamichebob: folds 
DoBrazil: folds 
thierryjc11: calls €0.02
pretinu2a: folds 
Zoryin: checks 
*** FLOP *** [Ts 3h Ac]
Zoryin: checks 
thierryjc11: bets €0.04
Zoryin: calls €0.04
*** TURN *** [Ts 3h Ac] [As]
Zoryin: checks 
thierryjc11: checks 
*** RIVER *** [Ts 3h Ac As] [5h]
Zoryin: checks 
thierryjc11: bets €0.06
Zoryin: folds 
Uncalled bet (€0.06) returned to thierryjc11
thierryjc11 collected €0.12 from pot
thierryjc11: doesn't show hand 
*** SUMMARY ***
Total pot €0.13 | Rake €0.01 
Board [Ts 3h Ac As 5h]
Seat 1: DoBrazil folded before Flop (didn't bet)
Seat 2: thierryjc11 (button) collected (€0.12)
Seat 3: pretinu2a (small blind) folded before Flop
Seat 4: Zoryin (big blind) folded on the River
Seat 5: mikrethor folded before Flop (didn't bet)
Seat 6: tamichebob folded before Flop (didn't bet)



PokerStars Hand #109566752660:  Hold'em No Limit (€0.01/€0.02 EUR) - 2014/01/04 13:58:16 CET [2014/01/04 7:58:16 ET]
Table 'Ambrosia III' 6-max Seat #3 is the button
Seat 1: DoBrazil (€1.97 in chips) 
Seat 2: thierryjc11 (€0.68 in chips) 
Seat 3: pretinu2a (€1.46 in chips) 
Seat 4: Zoryin (€2.13 in chips) 
Seat 5: mikrethor (€2.11 in chips) 
Seat 6: tamichebob (€1.84 in chips) 
Zoryin: posts small blind €0.01
mikrethor: posts big blind €0.02
*** HOLE CARDS ***
Dealt to mikrethor [5d Kh]
tamichebob: folds 
DoBrazil: folds 
thierryjc11: calls €0.02
pretinu2a: folds 
Zoryin: folds 
mikrethor: raises €0.06 to €0.08
thierryjc11: calls €0.06
*** FLOP *** [Qh 2c 4c]
mikrethor: checks 
thierryjc11: checks 
*** TURN *** [Qh 2c 4c] [3d]
mikrethor: bets €0.08
thierryjc11: folds 
Uncalled bet (€0.08) returned to mikrethor
mikrethor collected €0.16 from pot
mikrethor: doesn't show hand 
*** SUMMARY ***
Total pot €0.17 | Rake €0.01 
Board [Qh 2c 4c 3d]
Seat 1: DoBrazil folded before Flop (didn't bet)
Seat 2: thierryjc11 folded on the Turn
Seat 3: pretinu2a (button) folded before Flop (didn't bet)
Seat 4: Zoryin (small blind) folded before Flop
Seat 5: mikrethor (big blind) collected (€0.16)
Seat 6: tamichebob folded before Flop (didn't bet)



PokerStars Hand #109566772716:  Hold'em No Limit (€0.01/€0.02 EUR) - 2014/01/04 13:58:54 CET [2014/01/04 7:58:54 ET]
Table 'Ambrosia III' 6-max Seat #4 is the button
Seat 1: DoBrazil (€1.97 in chips) 
Seat 2: thierryjc11 (€0.60 in chips) 
Seat 3: pretinu2a (€1.46 in chips) 
Seat 4: Zoryin (€2.12 in chips) 
Seat 5: mikrethor (€2.19 in chips) 
Seat 6: tamichebob (€1.84 in chips) 
mikrethor: posts small blind €0.01
tamichebob: posts big blind €0.02
*** HOLE CARDS ***
Dealt to mikrethor [6d Jh]
DoBrazil: folds 
thierryjc11: folds 
pretinu2a: folds 
Zoryin: raises €0.04 to €0.06
mikrethor: folds 
tamichebob: folds 
Uncalled bet (€0.04) returned to Zoryin
Zoryin collected €0.05 from pot
Zoryin: doesn't show hand 
*** SUMMARY ***
Total pot €0.05 | Rake €0 
Seat 1: DoBrazil folded before Flop (didn't bet)
Seat 2: thierryjc11 folded before Flop (didn't bet)
Seat 3: pretinu2a folded before Flop (didn't bet)
Seat 4: Zoryin (button) collected (€0.05)
Seat 5: mikrethor (small blind) folded before Flop
Seat 6: tamichebob (big blind) folded before Flop



PokerStars Hand #109566780353:  Hold'em No Limit (€0.01/€0.02 EUR) - 2014/01/04 13:59:08 CET [2014/01/04 7:59:08 ET]
Table 'Ambrosia III' 6-max Seat #5 is the button
Seat 1: DoBrazil (€1.97 in chips) 
Seat 2: thierryjc11 (€0.60 in chips) 
Seat 3: pretinu2a (€1.46 in chips) 
Seat 4: Zoryin (€2.15 in chips) 
Seat 5: mikrethor (€2.18 in chips) 
Seat 6: tamichebob (€1.82 in chips) 
tamichebob: posts small blind €0.01
DoBrazil: posts big blind €0.02
*** HOLE CARDS ***
Dealt to mikrethor [4c 5s]
thierryjc11: calls €0.02
pretinu2a: calls €0.02
Zoryin: folds 
mikrethor: folds 
tamichebob: folds 
DoBrazil: checks 
*** FLOP *** [Th 8c Jd]
DoBrazil: checks 
thierryjc11: bets €0.04
pretinu2a: folds 
DoBrazil: folds 
Uncalled bet (€0.04) returned to thierryjc11
thierryjc11 collected €0.07 from pot
thierryjc11: doesn't show hand 
*** SUMMARY ***
Total pot €0.07 | Rake €0 
Board [Th 8c Jd]
Seat 1: DoBrazil (big blind) folded on the Flop
Seat 2: thierryjc11 collected (€0.07)
Seat 3: pretinu2a folded on the Flop
Seat 4: Zoryin folded before Flop (didn't bet)
Seat 5: mikrethor (button) folded before Flop (didn't bet)
Seat 6: tamichebob (small blind) folded before Flop



PokerStars Hand #109566791014:  Hold'em No Limit (€0.01/€0.02 EUR) - 2014/01/04 13:59:29 CET [2014/01/04 7:59:29 ET]
Table 'Ambrosia III' 6-max Seat #6 is the button
Seat 1: DoBrazil (€1.95 in chips) 
Seat 2: thierryjc11 (€0.65 in chips) 
Seat 3: pretinu2a (€1.44 in chips) 
Seat 4: Zoryin (€2.15 in chips) 
Seat 5: mikrethor (€2.18 in chips) 
Seat 6: tamichebob (€1.81 in chips) 
DoBrazil: posts small blind €0.01
thierryjc11: posts big blind €0.02
*** HOLE CARDS ***
Dealt to mikrethor [3s Th]
pretinu2a: calls €0.02
Zoryin: folds 
mikrethor: folds 
tamichebob: calls €0.02
DoBrazil: calls €0.01
thierryjc11: raises €0.63 to €0.65 and is all-in
pretinu2a: folds 
tamichebob: folds 
DoBrazil: folds 
Uncalled bet (€0.63) returned to thierryjc11
thierryjc11 collected €0.08 from pot
thierryjc11: doesn't show hand 
*** SUMMARY ***
Total pot €0.08 | Rake €0 
Seat 1: DoBrazil (small blind) folded before Flop
Seat 2: thierryjc11 (big blind) collected (€0.08)
Seat 3: pretinu2a folded before Flop
Seat 4: Zoryin folded before Flop (didn't bet)
Seat 5: mikrethor folded before Flop (didn't bet)
Seat 6: tamichebob (button) folded before Flop



PokerStars Hand #109566809088:  Hold'em No Limit (€0.01/€0.02 EUR) - 2014/01/04 14:00:03 CET [2014/01/04 8:00:03 ET]
Table 'Ambrosia III' 6-max Seat #1 is the button
Seat 1: DoBrazil (€2 in chips) 
Seat 2: thierryjc11 (€0.71 in chips) 
Seat 3: pretinu2a (€1.42 in chips) 
Seat 4: Zoryin (€2.15 in chips) 
Seat 5: mikrethor (€2.18 in chips) 
Seat 6: tamichebob (€1.79 in chips) 
thierryjc11: posts small blind €0.01
pretinu2a: posts big blind €0.02
*** HOLE CARDS ***
Dealt to mikrethor [6h 6d]
Zoryin: folds 
mikrethor: raises €0.08 to €0.10
Zoryin leaves the table
tamichebob: folds 
DoBrazil: folds 
thierryjc11: folds 
pretinu2a: calls €0.08
*** FLOP *** [8c Kd 9d]
Safakab joins the table at seat #4 
pretinu2a: checks 
mikrethor: bets €0.10
pretinu2a: calls €0.10
*** TURN *** [8c Kd 9d] [Jh]
pretinu2a: checks 
mikrethor: checks 
*** RIVER *** [8c Kd 9d Jh] [Qc]
pretinu2a: bets €0.16
mikrethor: folds 
Uncalled bet (€0.16) returned to pretinu2a
pretinu2a collected €0.39 from pot
pretinu2a: doesn't show hand 
*** SUMMARY ***
Total pot €0.41 | Rake €0.02 
Board [8c Kd 9d Jh Qc]
Seat 1: DoBrazil (button) folded before Flop (didn't bet)
Seat 2: thierryjc11 (small blind) folded before Flop
Seat 3: pretinu2a (big blind) collected (€0.39)
Seat 4: Zoryin folded before Flop (didn't bet)
Seat 5: mikrethor folded on the River
Seat 6: tamichebob folded before Flop (didn't bet)



PokerStars Hand #109566838274:  Hold'em No Limit (€0.01/€0.02 EUR) - 2014/01/04 14:00:51 CET [2014/01/04 8:00:51 ET]
Table 'Ambrosia III' 6-max Seat #2 is the button
Seat 1: DoBrazil (€2 in chips) 
Seat 2: thierryjc11 (€0.70 in chips) 
Seat 3: pretinu2a (€1.61 in chips) 
Seat 4: Safakab (€2 in chips) 
Seat 5: mikrethor (€1.98 in chips) 
Seat 6: tamichebob (€1.79 in chips) 
pretinu2a: posts small blind €0.01
Safakab: posts big blind €0.02
*** HOLE CARDS ***
Dealt to mikrethor [6c 5s]
mikrethor: folds 
tamichebob: raises €0.04 to €0.06
DoBrazil: folds 
thierryjc11: calls €0.06
pretinu2a: calls €0.05
Safakab: folds 
*** FLOP *** [Td 2h 3d]
pretinu2a: checks 
tamichebob: checks 
thierryjc11: bets €0.04
pretinu2a: calls €0.04
tamichebob: calls €0.04
*** TURN *** [Td 2h 3d] [Ad]
pretinu2a: checks 
tamichebob: checks 
thierryjc11: checks 
*** RIVER *** [Td 2h 3d Ad] [Qs]
pretinu2a: checks 
tamichebob: bets €0.14
thierryjc11: folds 
pretinu2a: calls €0.14
*** SHOW DOWN ***
tamichebob: shows [Kd Ac] (a pair of Aces)
pretinu2a: mucks hand 
tamichebob collected €0.56 from pot
*** SUMMARY ***
Total pot €0.60 | Rake €0.04 
Board [Td 2h 3d Ad Qs]
Seat 1: DoBrazil folded before Flop (didn't bet)
Seat 2: thierryjc11 (button) folded on the River
Seat 3: pretinu2a (small blind) mucked [Ah 8h]
Seat 4: Safakab (big blind) folded before Flop
Seat 5: mikrethor folded before Flop (didn't bet)
Seat 6: tamichebob showed [Kd Ac] and won (€0.56) with a pair of Aces



PokerStars Hand #109566889000:  Hold'em No Limit (€0.01/€0.02 EUR) - 2014/01/04 14:02:10 CET [2014/01/04 8:02:10 ET]
Table 'Ambrosia III' 6-max Seat #3 is the button
Seat 1: DoBrazil (€2 in chips) 
Seat 2: thierryjc11 (€0.60 in chips) 
Seat 3: pretinu2a (€1.37 in chips) 
Seat 4: Safakab (€2 in chips) 
Seat 5: mikrethor (€1.98 in chips) 
Seat 6: tamichebob (€2.11 in chips) 
Safakab: posts small blind €0.01
mikrethor: posts big blind €0.02
*** HOLE CARDS ***
Dealt to mikrethor [Jh Kc]
tamichebob: folds 
DoBrazil: folds 
thierryjc11: folds 
pretinu2a: calls €0.02
Safakab: folds 
mikrethor: raises €0.06 to €0.08
pretinu2a: calls €0.06
*** FLOP *** [Ts Th 3h]
mikrethor: checks 
pretinu2a: checks 
*** TURN *** [Ts Th 3h] [6c]
mikrethor: bets €0.08
pretinu2a: calls €0.08
*** RIVER *** [Ts Th 3h 6c] [5d]
mikrethor: bets €0.14
pretinu2a: calls €0.14
*** SHOW DOWN ***
mikrethor: shows [Jh Kc] (a pair of Tens)
pretinu2a: shows [As 6s] (two pair, Tens and Sixes)
pretinu2a collected €0.57 from pot
*** SUMMARY ***
Total pot €0.61 | Rake €0.04 
Board [Ts Th 3h 6c 5d]
Seat 1: DoBrazil folded before Flop (didn't bet)
Seat 2: thierryjc11 folded before Flop (didn't bet)
Seat 3: pretinu2a (button) showed [As 6s] and won (€0.57) with two pair, Tens and Sixes
Seat 4: Safakab (small blind) folded before Flop
Seat 5: mikrethor (big blind) showed [Jh Kc] and lost with a pair of Tens
Seat 6: tamichebob folded before Flop (didn't bet)



PokerStars Hand #109566914035:  Hold'em No Limit (€0.01/€0.02 EUR) - 2014/01/04 14:02:47 CET [2014/01/04 8:02:47 ET]
Table 'Ambrosia III' 6-max Seat #4 is the button
Seat 1: DoBrazil (€2 in chips) 
Seat 2: thierryjc11 (€0.60 in chips) 
Seat 3: pretinu2a (€1.64 in chips) 
Seat 4: Safakab (€2 in chips) 
Seat 5: mikrethor (€1.68 in chips) 
Seat 6: tamichebob (€2.11 in chips) 
mikrethor: posts small blind €0.01
tamichebob: posts big blind €0.02
*** HOLE CARDS ***
Dealt to mikrethor [3h 3d]
DoBrazil: folds 
thierryjc11: calls €0.02
pretinu2a: calls €0.02
Safakab: folds 
mikrethor: calls €0.01
tamichebob: checks 
*** FLOP *** [Kd 8h 6h]
mikrethor: checks 
tamichebob: checks 
thierryjc11: bets €0.02
pretinu2a: calls €0.02
mikrethor: calls €0.02
tamichebob: calls €0.02
*** TURN *** [Kd 8h 6h] [Qs]
mikrethor: checks 
tamichebob: folds 
tamichebob leaves the table
thierryjc11: bets €0.02
pretinu2a: calls €0.02
mikrethor: calls €0.02
*** RIVER *** [Kd 8h 6h Qs] [3c]
mikrethor: bets €0.20
maximo5565 joins the table at seat #6 
thierryjc11: folds 
pretinu2a: calls €0.20
*** SHOW DOWN ***
mikrethor: shows [3h 3d] (three of a kind, Threes)
pretinu2a: mucks hand 
mikrethor collected €0.58 from pot
*** SUMMARY ***
Total pot €0.62 | Rake €0.04 
Board [Kd 8h 6h Qs 3c]
Seat 1: DoBrazil folded before Flop (didn't bet)
Seat 2: thierryjc11 folded on the River
Seat 3: pretinu2a mucked [2s Kc]
Seat 4: Safakab (button) folded before Flop (didn't bet)
Seat 5: mikrethor (small blind) showed [3h 3d] and won (€0.58) with three of a kind, Threes
Seat 6: tamichebob (big blind) folded on the Turn



PokerStars Hand #109566954163:  Hold'em No Limit (€0.01/€0.02 EUR) - 2014/01/04 14:03:46 CET [2014/01/04 8:03:46 ET]
Table 'Ambrosia III' 6-max Seat #5 is the button
Seat 1: DoBrazil (€2 in chips) 
Seat 2: thierryjc11 (€0.54 in chips) 
Seat 3: pretinu2a (€1.38 in chips) 
Seat 4: Safakab (€2 in chips) 
Seat 5: mikrethor (€2 in chips) 
maximo5565 will be allowed to play after the button
DoBrazil: posts small blind €0.01
thierryjc11: posts big blind €0.02
*** HOLE CARDS ***
Dealt to mikrethor [6d 6s]
pretinu2a: folds 
Safakab: folds 
mikrethor: raises €0.04 to €0.06
DoBrazil: folds 
thierryjc11: calls €0.04
*** FLOP *** [2s Tc Ad]
thierryjc11: checks 
mikrethor: bets €0.06
thierryjc11: calls €0.06
*** TURN *** [2s Tc Ad] [4c]
thierryjc11: checks 
mikrethor: checks 
*** RIVER *** [2s Tc Ad 4c] [Kd]
thierryjc11: bets €0.06
mikrethor: calls €0.06
*** SHOW DOWN ***
thierryjc11: shows [Ac 9c] (a pair of Aces)
mikrethor: mucks hand 
thierryjc11 collected €0.35 from pot
*** SUMMARY ***
Total pot €0.37 | Rake €0.02 
Board [2s Tc Ad 4c Kd]
Seat 1: DoBrazil (small blind) folded before Flop
Seat 2: thierryjc11 (big blind) showed [Ac 9c] and won (€0.35) with a pair of Aces
Seat 3: pretinu2a folded before Flop (didn't bet)
Seat 4: Safakab folded before Flop (didn't bet)
Seat 5: mikrethor (button) mucked [6d 6s]



PokerStars Hand #109566977953:  Hold'em No Limit (€0.01/€0.02 EUR) - 2014/01/04 14:04:21 CET [2014/01/04 8:04:21 ET]
Table 'Ambrosia III' 6-max Seat #1 is the button
Seat 1: DoBrazil (€1.99 in chips) 
Seat 2: thierryjc11 (€0.71 in chips) 
Seat 3: pretinu2a (€1.38 in chips) 
Seat 4: Safakab (€2 in chips) 
Seat 5: mikrethor (€1.82 in chips) 
thierryjc11: posts small blind €0.01
pretinu2a: posts big blind €0.02
maximo5565: sits out 
*** HOLE CARDS ***
Dealt to mikrethor [8c 7d]
Safakab: folds 
mikrethor: calls €0.02
DoBrazil: folds 
thierryjc11: calls €0.01
pretinu2a: checks 
*** FLOP *** [As 6c 5h]
thierryjc11: bets €0.02
pretinu2a: folds 
mikrethor: raises €0.04 to €0.06
thierryjc11: folds 
Uncalled bet (€0.04) returned to mikrethor
mikrethor collected €0.09 from pot
mikrethor: doesn't show hand 
*** SUMMARY ***
Total pot €0.10 | Rake €0.01 
Board [As 6c 5h]
Seat 1: DoBrazil (button) folded before Flop (didn't bet)
Seat 2: thierryjc11 (small blind) folded on the Flop
Seat 3: pretinu2a (big blind) folded on the Flop
Seat 4: Safakab folded before Flop (didn't bet)
Seat 5: mikrethor collected (€0.09)



PokerStars Hand #109566999545:  Hold'em No Limit (€0.01/€0.02 EUR) - 2014/01/04 14:04:53 CET [2014/01/04 8:04:53 ET]
Table 'Ambrosia III' 6-max Seat #2 is the button
Seat 1: DoBrazil (€1.99 in chips) 
Seat 2: thierryjc11 (€0.67 in chips) 
Seat 3: pretinu2a (€1.36 in chips) 
Seat 4: Safakab (€2 in chips) 
Seat 5: mikrethor (€1.87 in chips) 
pretinu2a: posts small blind €0.01
Safakab: posts big blind €0.02
maximo5565: sits out 
*** HOLE CARDS ***
Dealt to mikrethor [5c 3d]
mikrethor: folds 
DoBrazil: folds 
thierryjc11: calls €0.02
pretinu2a: calls €0.01
Safakab: raises €0.06 to €0.08
thierryjc11: calls €0.06
pretinu2a: folds 
*** FLOP *** [Th 9d 6c]
Safakab: checks 
thierryjc11: checks 
*** TURN *** [Th 9d 6c] [Kd]
Safakab: checks 
thierryjc11: checks 
*** RIVER *** [Th 9d 6c Kd] [6h]
Safakab: checks 
thierryjc11: bets €0.08
Safakab: calls €0.08
*** SHOW DOWN ***
thierryjc11: shows [3c 3s] (two pair, Sixes and Threes)
Safakab: mucks hand 
thierryjc11 collected €0.32 from pot
*** SUMMARY ***
Total pot €0.34 | Rake €0.02 
Board [Th 9d 6c Kd 6h]
Seat 1: DoBrazil folded before Flop (didn't bet)
Seat 2: thierryjc11 (button) showed [3c 3s] and won (€0.32) with two pair, Sixes and Threes
Seat 3: pretinu2a (small blind) folded before Flop
Seat 4: Safakab (big blind) mucked [Ah 8h]
Seat 5: mikrethor folded before Flop (didn't bet)



PokerStars Hand #109567034945:  Hold'em No Limit (€0.01/€0.02 EUR) - 2014/01/04 14:05:44 CET [2014/01/04 8:05:44 ET]
Table 'Ambrosia III' 6-max Seat #3 is the button
Seat 1: DoBrazil (€1.99 in chips) 
Seat 2: thierryjc11 (€0.83 in chips) 
Seat 3: pretinu2a (€1.34 in chips) 
Seat 4: Safakab (€2 in chips) 
Seat 5: mikrethor (€1.87 in chips) 
Safakab: posts small blind €0.01
mikrethor: posts big blind €0.02
maximo5565: sits out 
*** HOLE CARDS ***
Dealt to mikrethor [8h Td]
DoBrazil: raises €0.06 to €0.08
thierryjc11: folds 
pretinu2a: folds 
Safakab: folds 
mikrethor: folds 
Uncalled bet (€0.06) returned to DoBrazil
DoBrazil collected €0.05 from pot
*** SUMMARY ***
Total pot €0.05 | Rake €0 
Seat 1: DoBrazil collected (€0.05)
Seat 2: thierryjc11 folded before Flop (didn't bet)
Seat 3: pretinu2a (button) folded before Flop (didn't bet)
Seat 4: Safakab (small blind) folded before Flop
Seat 5: mikrethor (big blind) folded before Flop



PokerStars Hand #109567044769:  Hold'em No Limit (€0.01/€0.02 EUR) - 2014/01/04 14:05:58 CET [2014/01/04 8:05:58 ET]
Table 'Ambrosia III' 6-max Seat #4 is the button
Seat 1: DoBrazil (€2.02 in chips) 
Seat 2: thierryjc11 (€0.83 in chips) 
Seat 3: pretinu2a (€1.34 in chips) 
Seat 4: Safakab (€2 in chips) 
Seat 5: mikrethor (€1.85 in chips) 
Seat 6: maximo5565 (€1.60 in chips) 
mikrethor: posts small blind €0.01
maximo5565: posts big blind €0.02
*** HOLE CARDS ***
Dealt to mikrethor [Th 7h]
DoBrazil: folds 
thierryjc11: calls €0.02
pretinu2a: folds 
Safakab: folds 
mikrethor: calls €0.01
maximo5565: checks 
*** FLOP *** [Ks Tc 7c]
mikrethor: bets €0.02
maximo5565: raises €0.06 to €0.08
thierryjc11: folds 
mikrethor: raises €0.22 to €0.30
maximo5565: calls €0.22
*** TURN *** [Ks Tc 7c] [Ad]
mikrethor: bets €0.62
maximo5565: calls €0.62
*** RIVER *** [Ks Tc 7c Ad] [3h]
mikrethor: bets €0.91 and is all-in
maximo5565: calls €0.66 and is all-in
Uncalled bet (€0.25) returned to mikrethor
*** SHOW DOWN ***
mikrethor: shows [Th 7h] (two pair, Tens and Sevens)
maximo5565: mucks hand 
mikrethor collected €3.03 from pot
*** SUMMARY ***
Total pot €3.22 | Rake €0.19 
Board [Ks Tc 7c Ad 3h]
Seat 1: DoBrazil folded before Flop (didn't bet)
Seat 2: thierryjc11 folded on the Flop
Seat 3: pretinu2a folded before Flop (didn't bet)
Seat 4: Safakab (button) folded before Flop (didn't bet)
Seat 5: mikrethor (small blind) showed [Th 7h] and won (€3.03) with two pair, Tens and Sevens
Seat 6: maximo5565 (big blind) mucked [Kh 4d]



PokerStars Hand #109567072320:  Hold'em No Limit (€0.01/€0.02 EUR) - 2014/01/04 14:06:38 CET [2014/01/04 8:06:38 ET]
Table 'Ambrosia III' 6-max Seat #5 is the button
Seat 1: DoBrazil (€2.02 in chips) 
Seat 2: thierryjc11 (€0.81 in chips) 
Seat 3: pretinu2a (€1.34 in chips) 
Seat 4: Safakab (€2 in chips) 
Seat 5: mikrethor (€3.28 in chips) 
DoBrazil: posts small blind €0.01
thierryjc11: posts big blind €0.02
*** HOLE CARDS ***
Dealt to mikrethor [3c 2h]
pretinu2a: folds 
Safakab: folds 
mikrethor: folds 
DoBrazil: folds 
Uncalled bet (€0.01) returned to thierryjc11
thierryjc11 collected €0.02 from pot
thierryjc11: doesn't show hand 
*** SUMMARY ***
Total pot €0.02 | Rake €0 
Seat 1: DoBrazil (small blind) folded before Flop
Seat 2: thierryjc11 (big blind) collected (€0.02)
Seat 3: pretinu2a folded before Flop (didn't bet)
Seat 4: Safakab folded before Flop (didn't bet)
Seat 5: mikrethor (button) folded before Flop (didn't bet)



PokerStars Hand #109567083838:  Hold'em No Limit (€0.01/€0.02 EUR) - 2014/01/04 14:06:55 CET [2014/01/04 8:06:55 ET]
Table 'Ambrosia III' 6-max Seat #1 is the button
Seat 1: DoBrazil (€2.01 in chips) 
Seat 2: thierryjc11 (€0.82 in chips) 
Seat 3: pretinu2a (€1.34 in chips) 
Seat 4: Safakab (€2 in chips) 
Seat 5: mikrethor (€3.28 in chips) 
thierryjc11: posts small blind €0.01
pretinu2a: posts big blind €0.02
maximo5565: sits out 
*** HOLE CARDS ***
Dealt to mikrethor [Th 6c]
Safakab: folds 
mikrethor: folds 
DoBrazil: folds 
thierryjc11: calls €0.01
pretinu2a: checks 
*** FLOP *** [Tc Ts Kh]
thierryjc11: bets €0.02
pretinu2a: folds 
Uncalled bet (€0.02) returned to thierryjc11
thierryjc11 collected €0.04 from pot
thierryjc11: doesn't show hand 
*** SUMMARY ***
Total pot €0.04 | Rake €0 
Board [Tc Ts Kh]
Seat 1: DoBrazil (button) folded before Flop (didn't bet)
Seat 2: thierryjc11 (small blind) collected (€0.04)
Seat 3: pretinu2a (big blind) folded on the Flop
Seat 4: Safakab folded before Flop (didn't bet)
Seat 5: mikrethor folded before Flop (didn't bet)



PokerStars Hand #109567110053:  Hold'em No Limit (€0.01/€0.02 EUR) - 2014/01/04 14:07:33 CET [2014/01/04 8:07:33 ET]
Table 'Ambrosia III' 6-max Seat #2 is the button
Seat 1: DoBrazil (€2.01 in chips) 
Seat 2: thierryjc11 (€0.84 in chips) 
Seat 3: pretinu2a (€1.32 in chips) 
Seat 4: Safakab (€2 in chips) 
Seat 5: mikrethor (€3.28 in chips) 
pretinu2a: posts small blind €0.01
Safakab: posts big blind €0.02
maximo5565: sits out 
*** HOLE CARDS ***
Dealt to mikrethor [8s Ac]
mikrethor: folds 
DoBrazil: folds 
thierryjc11: calls €0.02
pretinu2a: calls €0.01
Safakab: raises €0.06 to €0.08
thierryjc11: folds 
pretinu2a: calls €0.06
*** FLOP *** [7d 3s Jh]
pretinu2a: checks 
Safakab: bets €0.11
pretinu2a: folds 
Uncalled bet (€0.11) returned to Safakab
Safakab collected €0.17 from pot
Safakab: doesn't show hand 
*** SUMMARY ***
Total pot €0.18 | Rake €0.01 
Board [7d 3s Jh]
Seat 1: DoBrazil folded before Flop (didn't bet)
Seat 2: thierryjc11 (button) folded before Flop
Seat 3: pretinu2a (small blind) folded on the Flop
Seat 4: Safakab (big blind) collected (€0.17)
Seat 5: mikrethor folded before Flop (didn't bet)



PokerStars Hand #109567132933:  Hold'em No Limit (€0.01/€0.02 EUR) - 2014/01/04 14:08:06 CET [2014/01/04 8:08:06 ET]
Table 'Ambrosia III' 6-max Seat #3 is the button
Seat 1: DoBrazil (€2.01 in chips) 
Seat 2: thierryjc11 (€0.82 in chips) 
Seat 3: pretinu2a (€1.24 in chips) 
Seat 4: Safakab (€2.09 in chips) 
Seat 5: mikrethor (€3.28 in chips) 
Safakab: posts small blind €0.01
mikrethor: posts big blind €0.02
maximo5565: sits out 
*** HOLE CARDS ***
Dealt to mikrethor [3h 5d]
DoBrazil: folds 
thierryjc11: calls €0.02
pretinu2a: calls €0.02
Safakab: folds 
mikrethor: checks 
*** FLOP *** [9h 7s Jd]
mikrethor: checks 
thierryjc11: bets €0.02
pretinu2a: calls €0.02
mikrethor: folds 
*** TURN *** [9h 7s Jd] [4s]
thierryjc11: bets €0.02
pretinu2a: raises €0.02 to €0.04
thierryjc11: calls €0.02
*** RIVER *** [9h 7s Jd 4s] [6h]
thierryjc11: checks 
pretinu2a: checks 
*** SHOW DOWN ***
thierryjc11: shows [Kd Qs] (high card King)
pretinu2a: shows [Qh Kc] (high card King)
thierryjc11 collected €0.09 from pot
pretinu2a collected €0.09 from pot
*** SUMMARY ***
Total pot €0.19 | Rake €0.01 
Board [9h 7s Jd 4s 6h]
Seat 1: DoBrazil folded before Flop (didn't bet)
Seat 2: thierryjc11 showed [Kd Qs] and won (€0.09) with high card King
Seat 3: pretinu2a (button) showed [Qh Kc] and won (€0.09) with high card King
Seat 4: Safakab (small blind) folded before Flop
Seat 5: mikrethor (big blind) folded on the Flop



PokerStars Hand #109567159514:  Hold'em No Limit (€0.01/€0.02 EUR) - 2014/01/04 14:08:44 CET [2014/01/04 8:08:44 ET]
Table 'Ambrosia III' 6-max Seat #4 is the button
Seat 1: DoBrazil (€2.01 in chips) 
Seat 2: thierryjc11 (€0.83 in chips) 
Seat 3: pretinu2a (€1.25 in chips) 
Seat 4: Safakab (€2.08 in chips) 
Seat 5: mikrethor (€3.26 in chips) 
Seat 6: maximo5565 (€2 in chips) 
mikrethor: posts small blind €0.01
maximo5565: posts big blind €0.02
*** HOLE CARDS ***
Dealt to mikrethor [Td 9h]
DoBrazil: folds 
thierryjc11: calls €0.02
pretinu2a: calls €0.02
Safakab: raises €0.06 to €0.08
mikrethor: folds 
maximo5565: calls €0.06
thierryjc11: folds 
pretinu2a: folds 
*** FLOP *** [6s Kc Ah]
maximo5565: checks 
Safakab: bets €0.11
maximo5565: calls €0.11
*** TURN *** [6s Kc Ah] [3d]
maximo5565: bets €0.14
Safakab: folds 
Uncalled bet (€0.14) returned to maximo5565
maximo5565 collected €0.40 from pot
*** SUMMARY ***
Total pot €0.43 | Rake €0.03 
Board [6s Kc Ah 3d]
Seat 1: DoBrazil folded before Flop (didn't bet)
Seat 2: thierryjc11 folded before Flop
Seat 3: pretinu2a folded before Flop
Seat 4: Safakab (button) folded on the Turn
Seat 5: mikrethor (small blind) folded before Flop
Seat 6: maximo5565 (big blind) collected (€0.40)



PokerStars Hand #109567193109:  Hold'em No Limit (€0.01/€0.02 EUR) - 2014/01/04 14:09:33 CET [2014/01/04 8:09:33 ET]
Table 'Ambrosia III' 6-max Seat #5 is the button
Seat 1: DoBrazil (€2.01 in chips) 
Seat 2: thierryjc11 (€0.81 in chips) 
Seat 3: pretinu2a (€1.23 in chips) 
Seat 4: Safakab (€2 in chips) 
Seat 5: mikrethor (€3.25 in chips) 
Seat 6: maximo5565 (€2.21 in chips) 
maximo5565: posts small blind €0.01
DoBrazil: posts big blind €0.02
*** HOLE CARDS ***
Dealt to mikrethor [4s Js]
thierryjc11: folds 
pretinu2a: folds 
Safakab: folds 
mikrethor: raises €0.06 to €0.08
maximo5565: calls €0.07
DoBrazil: calls €0.06
*** FLOP *** [Qd Ah 9d]
maximo5565: bets €0.04
DoBrazil: raises €0.12 to €0.16
mikrethor: folds 
maximo5565: calls €0.12
*** TURN *** [Qd Ah 9d] [2c]
maximo5565: checks 
DoBrazil: bets €0.32
maximo5565: calls €0.32
*** RIVER *** [Qd Ah 9d 2c] [8h]
maximo5565: checks 
DoBrazil: checks 
*** SHOW DOWN ***
maximo5565: shows [Kd Jd] (high card Ace)
DoBrazil: shows [Qh 9h] (two pair, Queens and Nines)
DoBrazil collected €1.13 from pot
*** SUMMARY ***
Total pot €1.20 | Rake €0.07 
Board [Qd Ah 9d 2c 8h]
Seat 1: DoBrazil (big blind) showed [Qh 9h] and won (€1.13) with two pair, Queens and Nines
Seat 2: thierryjc11 folded before Flop (didn't bet)
Seat 3: pretinu2a folded before Flop (didn't bet)
Seat 4: Safakab folded before Flop (didn't bet)
Seat 5: mikrethor (button) folded on the Flop
Seat 6: maximo5565 (small blind) showed [Kd Jd] and lost with high card Ace



PokerStars Hand #109567230905:  Hold'em No Limit (€0.01/€0.02 EUR) - 2014/01/04 14:10:28 CET [2014/01/04 8:10:28 ET]
Table 'Ambrosia III' 6-max Seat #6 is the button
Seat 1: DoBrazil (€2.58 in chips) 
Seat 2: thierryjc11 (€0.81 in chips) 
Seat 3: pretinu2a (€1.23 in chips) 
Seat 4: Safakab (€2 in chips) 
Seat 5: mikrethor (€3.17 in chips) 
Seat 6: maximo5565 (€1.65 in chips) 
DoBrazil: posts small blind €0.01
thierryjc11: posts big blind €0.02
*** HOLE CARDS ***
Dealt to mikrethor [Tc 9d]
pretinu2a: folds 
Safakab: folds 
mikrethor: calls €0.02
maximo5565: calls €0.02
DoBrazil: calls €0.01
thierryjc11: checks 
*** FLOP *** [8s Ah 2c]
DoBrazil: checks 
thierryjc11: checks 
mikrethor: checks 
maximo5565: checks 
*** TURN *** [8s Ah 2c] [Td]
DoBrazil: checks 
thierryjc11: bets €0.02
mikrethor: raises €0.06 to €0.08
maximo5565: folds 
DoBrazil: folds 
thierryjc11: folds 
Uncalled bet (€0.06) returned to mikrethor
mikrethor collected €0.11 from pot
mikrethor: doesn't show hand 
*** SUMMARY ***
Total pot €0.12 | Rake €0.01 
Board [8s Ah 2c Td]
Seat 1: DoBrazil (small blind) folded on the Turn
Seat 2: thierryjc11 (big blind) folded on the Turn
Seat 3: pretinu2a folded before Flop (didn't bet)
Seat 4: Safakab folded before Flop (didn't bet)
Seat 5: mikrethor collected (€0.11)
Seat 6: maximo5565 (button) folded on the Turn



PokerStars Hand #109567262926:  Hold'em No Limit (€0.01/€0.02 EUR) - 2014/01/04 14:11:15 CET [2014/01/04 8:11:15 ET]
Table 'Ambrosia III' 6-max Seat #1 is the button
Seat 1: DoBrazil (€2.56 in chips) 
Seat 2: thierryjc11 (€0.77 in chips) 
Seat 3: pretinu2a (€1.23 in chips) 
Seat 4: Safakab (€2 in chips) 
Seat 5: mikrethor (€3.24 in chips) 
Seat 6: maximo5565 (€1.63 in chips) 
thierryjc11: posts small blind €0.01
pretinu2a: posts big blind €0.02
*** HOLE CARDS ***
Dealt to mikrethor [5d Ks]
Safakab: folds 
mikrethor: folds 
maximo5565: calls €0.02
DoBrazil: folds 
thierryjc11: calls €0.01
pretinu2a: checks 
*** FLOP *** [9d 2c 9s]
thierryjc11: bets €0.02
pretinu2a: folds 
maximo5565: calls €0.02
*** TURN *** [9d 2c 9s] [8d]
thierryjc11: bets €0.02
maximo5565: calls €0.02
*** RIVER *** [9d 2c 9s 8d] [3d]
thierryjc11: bets €0.04
maximo5565: calls €0.04
*** SHOW DOWN ***
thierryjc11: shows [2s 6c] (two pair, Nines and Deuces)
maximo5565: mucks hand 
thierryjc11 collected €0.21 from pot
*** SUMMARY ***
Total pot €0.22 | Rake €0.01 
Board [9d 2c 9s 8d 3d]
Seat 1: DoBrazil (button) folded before Flop (didn't bet)
Seat 2: thierryjc11 (small blind) showed [2s 6c] and won (€0.21) with two pair, Nines and Deuces
Seat 3: pretinu2a (big blind) folded on the Flop
Seat 4: Safakab folded before Flop (didn't bet)
Seat 5: mikrethor folded before Flop (didn't bet)
Seat 6: maximo5565 mucked [Js Ah]



PokerStars Hand #109567290925:  Hold'em No Limit (€0.01/€0.02 EUR) - 2014/01/04 14:11:55 CET [2014/01/04 8:11:55 ET]
Table 'Ambrosia III' 6-max Seat #2 is the button
Seat 1: DoBrazil (€2.56 in chips) 
Seat 2: thierryjc11 (€0.88 in chips) 
Seat 3: pretinu2a (€1.21 in chips) 
Seat 4: Safakab (€2 in chips) 
Seat 5: mikrethor (€3.24 in chips) 
Seat 6: maximo5565 (€1.53 in chips) 
pretinu2a: posts small blind €0.01
Safakab: posts big blind €0.02
*** HOLE CARDS ***
Dealt to mikrethor [8s Jd]
mikrethor: folds 
maximo5565: raises €0.08 to €0.10
DoBrazil: folds 
thierryjc11: folds 
pretinu2a: folds 
Safakab: folds 
Uncalled bet (€0.08) returned to maximo5565
maximo5565 collected €0.05 from pot
*** SUMMARY ***
Total pot €0.05 | Rake €0 
Seat 1: DoBrazil folded before Flop (didn't bet)
Seat 2: thierryjc11 (button) folded before Flop (didn't bet)
Seat 3: pretinu2a (small blind) folded before Flop
Seat 4: Safakab (big blind) folded before Flop
Seat 5: mikrethor folded before Flop (didn't bet)
Seat 6: maximo5565 collected (€0.05)



PokerStars Hand #109567301157:  Hold'em No Limit (€0.01/€0.02 EUR) - 2014/01/04 14:12:10 CET [2014/01/04 8:12:10 ET]
Table 'Ambrosia III' 6-max Seat #3 is the button
Seat 1: DoBrazil (€2.56 in chips) 
Seat 2: thierryjc11 (€0.88 in chips) 
Seat 3: pretinu2a (€1.20 in chips) 
Seat 4: Safakab (€2 in chips) 
Seat 5: mikrethor (€3.24 in chips) 
Seat 6: maximo5565 (€1.56 in chips) 
Safakab: posts small blind €0.01
mikrethor: posts big blind €0.02
*** HOLE CARDS ***
Dealt to mikrethor [2h Qd]
maximo5565: folds 
DoBrazil: folds 
thierryjc11: folds 
pretinu2a: folds 
Safakab: raises €0.06 to €0.08
mikrethor: folds 
Uncalled bet (€0.06) returned to Safakab
Safakab collected €0.04 from pot
Safakab: doesn't show hand 
*** SUMMARY ***
Total pot €0.04 | Rake €0 
Seat 1: DoBrazil folded before Flop (didn't bet)
Seat 2: thierryjc11 folded before Flop (didn't bet)
Seat 3: pretinu2a (button) folded before Flop (didn't bet)
Seat 4: Safakab (small blind) collected (€0.04)
Seat 5: mikrethor (big blind) folded before Flop
Seat 6: maximo5565 folded before Flop (didn't bet)



PokerStars Hand #109567314710:  Hold'em No Limit (€0.01/€0.02 EUR) - 2014/01/04 14:12:29 CET [2014/01/04 8:12:29 ET]
Table 'Ambrosia III' 6-max Seat #4 is the button
Seat 1: DoBrazil (€2.56 in chips) 
Seat 2: thierryjc11 (€0.88 in chips) 
Seat 3: pretinu2a (€1.20 in chips) 
Seat 4: Safakab (€2.02 in chips) 
Seat 5: mikrethor (€3.22 in chips) 
Seat 6: maximo5565 (€1.56 in chips) 
mikrethor: posts small blind €0.01
maximo5565: posts big blind €0.02
*** HOLE CARDS ***
Dealt to mikrethor [6d 3c]
DoBrazil: folds 
thierryjc11: calls €0.02
pretinu2a: calls €0.02
Safakab: folds 
mikrethor: folds 
maximo5565: checks 
*** FLOP *** [5s Td 2c]
maximo5565: checks 
thierryjc11: bets €0.02
pretinu2a: folds 
maximo5565: folds 
Uncalled bet (€0.02) returned to thierryjc11
thierryjc11 collected €0.07 from pot
thierryjc11: doesn't show hand 
*** SUMMARY ***
Total pot €0.07 | Rake €0 
Board [5s Td 2c]
Seat 1: DoBrazil folded before Flop (didn't bet)
Seat 2: thierryjc11 collected (€0.07)
Seat 3: pretinu2a folded on the Flop
Seat 4: Safakab (button) folded before Flop (didn't bet)
Seat 5: mikrethor (small blind) folded before Flop
Seat 6: maximo5565 (big blind) folded on the Flop



PokerStars Hand #109567340858:  Hold'em No Limit (€0.01/€0.02 EUR) - 2014/01/04 14:13:07 CET [2014/01/04 8:13:07 ET]
Table 'Ambrosia III' 6-max Seat #5 is the button
Seat 1: DoBrazil (€2.56 in chips) 
Seat 2: thierryjc11 (€0.93 in chips) 
Seat 3: pretinu2a (€1.18 in chips) 
Seat 4: Safakab (€2.02 in chips) 
Seat 5: mikrethor (€3.21 in chips) 
Seat 6: maximo5565 (€1.54 in chips) 
maximo5565: posts small blind €0.01
DoBrazil: posts big blind €0.02
*** HOLE CARDS ***
Dealt to mikrethor [3h 6d]
thierryjc11: calls €0.02
pretinu2a: folds 
Safakab: raises €0.06 to €0.08
mikrethor: folds 
maximo5565: folds 
DoBrazil: folds 
thierryjc11: raises €0.85 to €0.93 and is all-in
Safakab: folds 
Uncalled bet (€0.85) returned to thierryjc11
thierryjc11 collected €0.19 from pot
thierryjc11: doesn't show hand 
*** SUMMARY ***
Total pot €0.19 | Rake €0 
Seat 1: DoBrazil (big blind) folded before Flop
Seat 2: thierryjc11 collected (€0.19)
Seat 3: pretinu2a folded before Flop (didn't bet)
Seat 4: Safakab folded before Flop
Seat 5: mikrethor (button) folded before Flop (didn't bet)
Seat 6: maximo5565 (small blind) folded before Flop



PokerStars Hand #109567355756:  Hold'em No Limit (€0.01/€0.02 EUR) - 2014/01/04 14:13:29 CET [2014/01/04 8:13:29 ET]
Table 'Ambrosia III' 6-max Seat #6 is the button
Seat 1: DoBrazil (€2.54 in chips) 
Seat 2: thierryjc11 (€1.04 in chips) 
Seat 3: pretinu2a (€1.18 in chips) 
Seat 4: Safakab (€2 in chips) 
Seat 5: mikrethor (€3.21 in chips) 
Seat 6: maximo5565 (€1.53 in chips) 
DoBrazil: posts small blind €0.01
thierryjc11: posts big blind €0.02
*** HOLE CARDS ***
Dealt to mikrethor [Jd 3d]
pretinu2a: calls €0.02
Safakab: folds 
mikrethor: folds 
maximo5565: calls €0.02
DoBrazil: folds 
thierryjc11: checks 
*** FLOP *** [8c As 2s]
thierryjc11: checks 
pretinu2a: checks 
maximo5565: checks 
*** TURN *** [8c As 2s] [6h]
thierryjc11: bets €0.02
pretinu2a: calls €0.02
maximo5565: calls €0.02
*** RIVER *** [8c As 2s 6h] [5c]
thierryjc11: bets €0.06
pretinu2a: folds 
maximo5565: folds 
Uncalled bet (€0.06) returned to thierryjc11
thierryjc11 collected €0.12 from pot
thierryjc11: doesn't show hand 
*** SUMMARY ***
Total pot €0.13 | Rake €0.01 
Board [8c As 2s 6h 5c]
Seat 1: DoBrazil (small blind) folded before Flop
Seat 2: thierryjc11 (big blind) collected (€0.12)
Seat 3: pretinu2a folded on the River
Seat 4: Safakab folded before Flop (didn't bet)
Seat 5: mikrethor folded before Flop (didn't bet)
Seat 6: maximo5565 (button) folded on the River



PokerStars Hand #109567384510:  Hold'em No Limit (€0.01/€0.02 EUR) - 2014/01/04 14:14:11 CET [2014/01/04 8:14:11 ET]
Table 'Ambrosia III' 6-max Seat #1 is the button
Seat 1: DoBrazil (€2.53 in chips) 
Seat 2: thierryjc11 (€1.12 in chips) 
Seat 3: pretinu2a (€1.14 in chips) 
Seat 4: Safakab (€2 in chips) 
Seat 5: mikrethor (€3.21 in chips) 
Seat 6: maximo5565 (€1.49 in chips) 
thierryjc11: posts small blind €0.01
pretinu2a: posts big blind €0.02
*** HOLE CARDS ***
Dealt to mikrethor [7s 5d]
Safakab: folds 
mikrethor: folds 
maximo5565: folds 
DoBrazil: folds 
thierryjc11: calls €0.01
pretinu2a: raises €0.42 to €0.44
thierryjc11: folds 
Uncalled bet (€0.42) returned to pretinu2a
pretinu2a collected €0.04 from pot
pretinu2a: doesn't show hand 
*** SUMMARY ***
Total pot €0.04 | Rake €0 
Seat 1: DoBrazil (button) folded before Flop (didn't bet)
Seat 2: thierryjc11 (small blind) folded before Flop
Seat 3: pretinu2a (big blind) collected (€0.04)
Seat 4: Safakab folded before Flop (didn't bet)
Seat 5: mikrethor folded before Flop (didn't bet)
Seat 6: maximo5565 folded before Flop (didn't bet)



PokerStars Hand #109567398722:  Hold'em No Limit (€0.01/€0.02 EUR) - 2014/01/04 14:14:31 CET [2014/01/04 8:14:31 ET]
Table 'Ambrosia III' 6-max Seat #2 is the button
Seat 1: DoBrazil (€2.53 in chips) 
Seat 2: thierryjc11 (€1.10 in chips) 
Seat 3: pretinu2a (€1.16 in chips) 
Seat 4: Safakab (€2 in chips) 
Seat 5: mikrethor (€3.21 in chips) 
Seat 6: maximo5565 (€1.49 in chips) 
pretinu2a: posts small blind €0.01
Safakab: posts big blind €0.02
*** HOLE CARDS ***
Dealt to mikrethor [As Th]
mikrethor: raises €0.04 to €0.06
maximo5565: calls €0.06
DoBrazil: folds 
thierryjc11: folds 
pretinu2a: calls €0.05
Safakab: raises €1.94 to €2 and is all-in
mikrethor: folds 
maximo5565: folds 
pretinu2a: folds 
Uncalled bet (€1.94) returned to Safakab
Safakab collected €0.24 from pot
Safakab: doesn't show hand 
*** SUMMARY ***
Total pot €0.24 | Rake €0 
Seat 1: DoBrazil folded before Flop (didn't bet)
Seat 2: thierryjc11 (button) folded before Flop (didn't bet)
Seat 3: pretinu2a (small blind) folded before Flop
Seat 4: Safakab (big blind) collected (€0.24)
Seat 5: mikrethor folded before Flop
Seat 6: maximo5565 folded before Flop



PokerStars Hand #109567424482:  Hold'em No Limit (€0.01/€0.02 EUR) - 2014/01/04 14:15:08 CET [2014/01/04 8:15:08 ET]
Table 'Ambrosia III' 6-max Seat #3 is the button
Seat 1: DoBrazil (€2.53 in chips) 
Seat 2: thierryjc11 (€1.10 in chips) 
Seat 3: pretinu2a (€1.10 in chips) 
Seat 4: Safakab (€2.18 in chips) 
Seat 5: mikrethor (€3.15 in chips) 
Seat 6: maximo5565 (€1.43 in chips) 
Safakab: posts small blind €0.01
mikrethor: posts big blind €0.02
*** HOLE CARDS ***
Dealt to mikrethor [As 6h]
maximo5565: folds 
DoBrazil: folds 
thierryjc11: folds 
pretinu2a: folds 
pretinu2a leaves the table
Safakab: folds 
Uncalled bet (€0.01) returned to mikrethor
mikrethor collected €0.02 from pot
mikrethor: doesn't show hand 
*** SUMMARY ***
Total pot €0.02 | Rake €0 
Seat 1: DoBrazil folded before Flop (didn't bet)
Seat 2: thierryjc11 folded before Flop (didn't bet)
Seat 3: pretinu2a (button) folded before Flop (didn't bet)
Seat 4: Safakab (small blind) folded before Flop
Seat 5: mikrethor (big blind) collected (€0.02)
Seat 6: maximo5565 folded before Flop (didn't bet)



PokerStars Hand #109567429703:  Hold'em No Limit (€0.01/€0.02 EUR) - 2014/01/04 14:15:15 CET [2014/01/04 8:15:15 ET]
Table 'Ambrosia III' 6-max Seat #4 is the button
Seat 1: DoBrazil (€2.53 in chips) 
Seat 2: thierryjc11 (€1.10 in chips) 
Seat 4: Safakab (€2.17 in chips) 
Seat 5: mikrethor (€3.16 in chips) 
Seat 6: maximo5565 (€1.43 in chips) 
mikrethor: posts small blind €0.01
maximo5565: posts big blind €0.02
*** HOLE CARDS ***
Dealt to mikrethor [Th Ts]
DoBrazil: folds 
thierryjc11: calls €0.02
Safakab: folds 
mikrethor: raises €0.06 to €0.08
maximo5565: folds 
thierryjc11: folds 
Uncalled bet (€0.06) returned to mikrethor
mikrethor collected €0.06 from pot
mikrethor: doesn't show hand 
*** SUMMARY ***
Total pot €0.06 | Rake €0 
Seat 1: DoBrazil folded before Flop (didn't bet)
Seat 2: thierryjc11 folded before Flop
Seat 4: Safakab (button) folded before Flop (didn't bet)
Seat 5: mikrethor (small blind) collected (€0.06)
Seat 6: maximo5565 (big blind) folded before Flop



PokerStars Hand #109567441315:  Hold'em No Limit (€0.01/€0.02 EUR) - 2014/01/04 14:15:32 CET [2014/01/04 8:15:32 ET]
Table 'Ambrosia III' 6-max Seat #5 is the button
Seat 1: DoBrazil (€2.53 in chips) 
Seat 2: thierryjc11 (€1.08 in chips) 
Seat 4: Safakab (€2.17 in chips) 
Seat 5: mikrethor (€3.20 in chips) 
Seat 6: maximo5565 (€1.41 in chips) 
maximo5565: posts small blind €0.01
DoBrazil: posts big blind €0.02
*** HOLE CARDS ***
Dealt to mikrethor [6d Kd]
thierryjc11: calls €0.02
Safakab: folds 
mikrethor: calls €0.02
maximo5565: calls €0.01
DoBrazil: checks 
*** FLOP *** [Th Ah 4h]
maximo5565: checks 
DoBrazil: checks 
thierryjc11: bets €0.02
mikrethor: calls €0.02
ROGER20220 joins the table at seat #3 
maximo5565: raises €0.10 to €0.12
DoBrazil: folds 
thierryjc11: folds 
mikrethor: folds 
Uncalled bet (€0.10) returned to maximo5565
maximo5565 collected €0.13 from pot
*** SUMMARY ***
Total pot €0.14 | Rake €0.01 
Board [Th Ah 4h]
Seat 1: DoBrazil (big blind) folded on the Flop
Seat 2: thierryjc11 folded on the Flop
Seat 4: Safakab folded before Flop (didn't bet)
Seat 5: mikrethor (button) folded on the Flop
Seat 6: maximo5565 (small blind) collected (€0.13)



PokerStars Hand #109567465146:  Hold'em No Limit (€0.01/€0.02 EUR) - 2014/01/04 14:16:06 CET [2014/01/04 8:16:06 ET]
Table 'Ambrosia III' 6-max Seat #6 is the button
Seat 1: DoBrazil (€2.51 in chips) 
Seat 2: thierryjc11 (€1.04 in chips) 
Seat 3: ROGER20220 (€1.60 in chips) 
Seat 4: Safakab (€2.17 in chips) 
Seat 5: mikrethor (€3.16 in chips) 
Seat 6: maximo5565 (€1.50 in chips) 
DoBrazil: posts small blind €0.01
thierryjc11: posts big blind €0.02
ROGER20220: posts big blind €0.02
*** HOLE CARDS ***
Dealt to mikrethor [Ad Qs]
ROGER20220: checks 
Safakab: folds 
mikrethor: raises €0.08 to €0.10
maximo5565: folds 
DoBrazil: folds 
thierryjc11: folds 
ROGER20220: folds 
Uncalled bet (€0.08) returned to mikrethor
mikrethor collected €0.07 from pot
mikrethor: doesn't show hand 
*** SUMMARY ***
Total pot €0.07 | Rake €0 
Seat 1: DoBrazil (small blind) folded before Flop
Seat 2: thierryjc11 (big blind) folded before Flop
Seat 3: ROGER20220 folded before Flop
Seat 4: Safakab folded before Flop (didn't bet)
Seat 5: mikrethor collected (€0.07)
Seat 6: maximo5565 (button) folded before Flop (didn't bet)



PokerStars Hand #109567480309:  Hold'em No Limit (€0.01/€0.02 EUR) - 2014/01/04 14:16:27 CET [2014/01/04 8:16:27 ET]
Table 'Ambrosia III' 6-max Seat #1 is the button
Seat 1: DoBrazil (€2.50 in chips) 
Seat 2: thierryjc11 (€1.02 in chips) 
Seat 3: ROGER20220 (€1.58 in chips) 
Seat 4: Safakab (€2.17 in chips) 
Seat 5: mikrethor (€3.21 in chips) 
Seat 6: maximo5565 (€1.50 in chips) 
thierryjc11: posts small blind €0.01
ROGER20220: posts big blind €0.02
*** HOLE CARDS ***
Dealt to mikrethor [6h 9h]
Safakab: raises €0.06 to €0.08
mikrethor: folds 
maximo5565: folds 
DoBrazil: folds 
thierryjc11: folds 
ROGER20220: calls €0.06
*** FLOP *** [2s 8h Jd]
ROGER20220: bets €0.04
Safakab: raises €0.19 to €0.23
ROGER20220: raises €0.19 to €0.42
Safakab: folds 
Uncalled bet (€0.19) returned to ROGER20220
ROGER20220 collected €0.59 from pot
ROGER20220: doesn't show hand 
*** SUMMARY ***
Total pot €0.63 | Rake €0.04 
Board [2s 8h Jd]
Seat 1: DoBrazil (button) folded before Flop (didn't bet)
Seat 2: thierryjc11 (small blind) folded before Flop
Seat 3: ROGER20220 (big blind) collected (€0.59)
Seat 4: Safakab folded on the Flop
Seat 5: mikrethor folded before Flop (didn't bet)
Seat 6: maximo5565 folded before Flop (didn't bet)



PokerStars Hand #109567516379:  Hold'em No Limit (€0.01/€0.02 EUR) - 2014/01/04 14:17:18 CET [2014/01/04 8:17:18 ET]
Table 'Ambrosia III' 6-max Seat #2 is the button
Seat 1: DoBrazil (€2.50 in chips) 
Seat 2: thierryjc11 (€1.01 in chips) 
Seat 3: ROGER20220 (€1.86 in chips) 
Seat 4: Safakab (€2 in chips) 
Seat 5: mikrethor (€3.21 in chips) 
Seat 6: maximo5565 (€1.50 in chips) 
ROGER20220: posts small blind €0.01
Safakab: posts big blind €0.02
*** HOLE CARDS ***
Dealt to mikrethor [Ks Qs]
mikrethor: raises €0.04 to €0.06
maximo5565 has timed out
maximo5565: folds 
DoBrazil: folds 
thierryjc11: calls €0.06
ROGER20220: raises €0.04 to €0.10
Safakab: folds 
mikrethor: calls €0.04
thierryjc11: calls €0.04
*** FLOP *** [3h 7c 6s]
ROGER20220: bets €0.14
mikrethor: folds 
thierryjc11: calls €0.14
*** TURN *** [3h 7c 6s] [7s]
ROGER20220: bets €0.20
thierryjc11: calls €0.20
*** RIVER *** [3h 7c 6s 7s] [5h]
ROGER20220: checks 
thierryjc11: bets €0.14
ROGER20220: calls €0.14
*** SHOW DOWN ***
thierryjc11: shows [7d Th] (three of a kind, Sevens)
ROGER20220: mucks hand 
thierryjc11 collected €1.20 from pot
*** SUMMARY ***
Total pot €1.28 | Rake €0.08 
Board [3h 7c 6s 7s 5h]
Seat 1: DoBrazil folded before Flop (didn't bet)
Seat 2: thierryjc11 (button) showed [7d Th] and won (€1.20) with three of a kind, Sevens
Seat 3: ROGER20220 (small blind) mucked [8c 8d]
Seat 4: Safakab (big blind) folded before Flop
Seat 5: mikrethor folded on the Flop
Seat 6: maximo5565 folded before Flop (didn't bet)



PokerStars Hand #109567572898:  Hold'em No Limit (€0.01/€0.02 EUR) - 2014/01/04 14:18:37 CET [2014/01/04 8:18:37 ET]
Table 'Ambrosia III' 6-max Seat #3 is the button
Seat 1: DoBrazil (€2.50 in chips) 
Seat 2: thierryjc11 (€1.63 in chips) 
Seat 3: ROGER20220 (€1.28 in chips) 
Seat 4: Safakab (€2 in chips) 
Seat 5: mikrethor (€3.11 in chips) 
Seat 6: maximo5565 (€1.50 in chips) 
Safakab: posts small blind €0.01
mikrethor: posts big blind €0.02
*** HOLE CARDS ***
Dealt to mikrethor [6s Ah]
maximo5565: calls €0.02
DoBrazil: folds 
thierryjc11: calls €0.02
ROGER20220: calls €0.02
Safakab: folds 
mikrethor: checks 
*** FLOP *** [7h Qh Th]
mikrethor: checks 
maximo5565: bets €0.04
thierryjc11: folds 
ROGER20220: raises €0.04 to €0.08
mikrethor: calls €0.08
maximo5565: calls €0.04
*** TURN *** [7h Qh Th] [3s]
mikrethor: checks 
maximo5565: checks 
ROGER20220: checks 
*** RIVER *** [7h Qh Th 3s] [Ts]
mikrethor: checks 
maximo5565: checks 
ROGER20220: bets €0.10
mikrethor: folds 
maximo5565: folds 
Uncalled bet (€0.10) returned to ROGER20220
ROGER20220 collected €0.31 from pot
ROGER20220: doesn't show hand 
*** SUMMARY ***
Total pot €0.33 | Rake €0.02 
Board [7h Qh Th 3s Ts]
Seat 1: DoBrazil folded before Flop (didn't bet)
Seat 2: thierryjc11 folded on the Flop
Seat 3: ROGER20220 (button) collected (€0.31)
Seat 4: Safakab (small blind) folded before Flop
Seat 5: mikrethor (big blind) folded on the River
Seat 6: maximo5565 folded on the River



PokerStars Hand #109567616565:  Hold'em No Limit (€0.01/€0.02 EUR) - 2014/01/04 14:19:39 CET [2014/01/04 8:19:39 ET]
Table 'Ambrosia III' 6-max Seat #4 is the button
Seat 1: DoBrazil (€2.50 in chips) 
Seat 2: thierryjc11 (€1.61 in chips) 
Seat 3: ROGER20220 (€1.49 in chips) 
Seat 4: Safakab (€2 in chips) 
Seat 5: mikrethor (€3.01 in chips) 
Seat 6: maximo5565 (€1.40 in chips) 
mikrethor: posts small blind €0.01
maximo5565: posts big blind €0.02
*** HOLE CARDS ***
Dealt to mikrethor [9c 6c]
DoBrazil: raises €0.06 to €0.08
thierryjc11: folds 
ROGER20220: folds 
Safakab: calls €0.08
mikrethor: folds 
maximo5565: folds 
*** FLOP *** [5d Kh 6d]
DoBrazil: bets €0.12
Safakab: calls €0.12
*** TURN *** [5d Kh 6d] [8s]
DoBrazil: bets €0.28
Safakab: folds 
Uncalled bet (€0.28) returned to DoBrazil
DoBrazil collected €0.40 from pot
*** SUMMARY ***
Total pot €0.43 | Rake €0.03 
Board [5d Kh 6d 8s]
Seat 1: DoBrazil collected (€0.40)
Seat 2: thierryjc11 folded before Flop (didn't bet)
Seat 3: ROGER20220 folded before Flop (didn't bet)
Seat 4: Safakab (button) folded on the Turn
Seat 5: mikrethor (small blind) folded before Flop
Seat 6: maximo5565 (big blind) folded before Flop



PokerStars Hand #109567637519:  Hold'em No Limit (€0.01/€0.02 EUR) - 2014/01/04 14:20:08 CET [2014/01/04 8:20:08 ET]
Table 'Ambrosia III' 6-max Seat #5 is the button
Seat 1: DoBrazil (€2.70 in chips) 
Seat 2: thierryjc11 (€1.61 in chips) 
Seat 3: ROGER20220 (€1.49 in chips) 
Seat 4: Safakab (€2 in chips) 
Seat 5: mikrethor (€3 in chips) 
Seat 6: maximo5565 (€1.38 in chips) 
maximo5565: posts small blind €0.01
DoBrazil: posts big blind €0.02
*** HOLE CARDS ***
Dealt to mikrethor [Jh 5c]
thierryjc11: calls €0.02
ROGER20220: folds 
Safakab: folds 
mikrethor: folds 
maximo5565: calls €0.01
DoBrazil: checks 
*** FLOP *** [3d 4s Td]
maximo5565: bets €0.04
DoBrazil: calls €0.04
thierryjc11: calls €0.04
*** TURN *** [3d 4s Td] [2h]
maximo5565: bets €0.06
DoBrazil: folds 
thierryjc11: calls €0.06
*** RIVER *** [3d 4s Td 2h] [Kd]
maximo5565: bets €0.06
thierryjc11: folds 
Uncalled bet (€0.06) returned to maximo5565
maximo5565 collected €0.28 from pot
*** SUMMARY ***
Total pot €0.30 | Rake €0.02 
Board [3d 4s Td 2h Kd]
Seat 1: DoBrazil (big blind) folded on the Turn
Seat 2: thierryjc11 folded on the River
Seat 3: ROGER20220 folded before Flop (didn't bet)
Seat 4: Safakab folded before Flop (didn't bet)
Seat 5: mikrethor (button) folded before Flop (didn't bet)
Seat 6: maximo5565 (small blind) collected (€0.28)



PokerStars Hand #109567662436:  Hold'em No Limit (€0.01/€0.02 EUR) - 2014/01/04 14:20:43 CET [2014/01/04 8:20:43 ET]
Table 'Ambrosia III' 6-max Seat #6 is the button
Seat 1: DoBrazil (€2.64 in chips) 
Seat 2: thierryjc11 (€1.49 in chips) 
Seat 3: ROGER20220 (€1.49 in chips) 
Seat 4: Safakab (€2 in chips) 
Seat 5: mikrethor (€3 in chips) 
Seat 6: maximo5565 (€1.54 in chips) 
DoBrazil: posts small blind €0.01
thierryjc11: posts big blind €0.02
*** HOLE CARDS ***
Dealt to mikrethor [9c 6h]
ROGER20220: raises €0.04 to €0.06
Safakab: raises €0.13 to €0.19
mikrethor: folds 
maximo5565: folds 
DoBrazil: folds 
thierryjc11: folds 
ROGER20220: raises €0.13 to €0.32
Safakab: raises €1.68 to €2 and is all-in
ROGER20220: folds 
Uncalled bet (€1.68) returned to Safakab
Safakab collected €0.67 from pot
Safakab: doesn't show hand 
*** SUMMARY ***
Total pot €0.67 | Rake €0 
Seat 1: DoBrazil (small blind) folded before Flop
Seat 2: thierryjc11 (big blind) folded before Flop
Seat 3: ROGER20220 folded before Flop
Seat 4: Safakab collected (€0.67)
Seat 5: mikrethor folded before Flop (didn't bet)
Seat 6: maximo5565 (button) folded before Flop (didn't bet)



PokerStars Hand #109567685216:  Hold'em No Limit (€0.01/€0.02 EUR) - 2014/01/04 14:21:15 CET [2014/01/04 8:21:15 ET]
Table 'Ambrosia III' 6-max Seat #1 is the button
Seat 1: DoBrazil (€2.63 in chips) 
Seat 2: thierryjc11 (€1.47 in chips) 
Seat 3: ROGER20220 (€1.17 in chips) 
Seat 4: Safakab (€2.35 in chips) 
Seat 5: mikrethor (€3 in chips) 
Seat 6: maximo5565 (€1.54 in chips) 
thierryjc11: posts small blind €0.01
ROGER20220: posts big blind €0.02
*** HOLE CARDS ***
Dealt to mikrethor [6s 6c]
Safakab: raises €0.06 to €0.08
mikrethor: calls €0.08
maximo5565: folds 
DoBrazil: folds 
thierryjc11: folds 
ROGER20220: folds 
*** FLOP *** [9d Qs Tc]
Safakab: checks 
mikrethor: bets €0.08
Safakab: folds 
Uncalled bet (€0.08) returned to mikrethor
mikrethor collected €0.18 from pot
mikrethor: doesn't show hand 
*** SUMMARY ***
Total pot €0.19 | Rake €0.01 
Board [9d Qs Tc]
Seat 1: DoBrazil (button) folded before Flop (didn't bet)
Seat 2: thierryjc11 (small blind) folded before Flop
Seat 3: ROGER20220 (big blind) folded before Flop
Seat 4: Safakab folded on the Flop
Seat 5: mikrethor collected (€0.18)
Seat 6: maximo5565 folded before Flop (didn't bet)



PokerStars Hand #109567700597:  Hold'em No Limit (€0.01/€0.02 EUR) - 2014/01/04 14:21:37 CET [2014/01/04 8:21:37 ET]
Table 'Ambrosia III' 6-max Seat #2 is the button
Seat 1: DoBrazil (€2.63 in chips) 
Seat 2: thierryjc11 (€1.46 in chips) 
Seat 3: ROGER20220 (€1.15 in chips) 
Seat 4: Safakab (€2.27 in chips) 
Seat 5: mikrethor (€3.10 in chips) 
Seat 6: maximo5565 (€1.54 in chips) 
ROGER20220: posts small blind €0.01
Safakab: posts big blind €0.02
*** HOLE CARDS ***
Dealt to mikrethor [2h Qs]
mikrethor: folds 
maximo5565: folds 
DoBrazil: folds 
thierryjc11: calls €0.02
ROGER20220: calls €0.01
maximo5565 leaves the table
Safakab: checks 
*** FLOP *** [7c 4c Qc]
ROGER20220: checks 
Safakab: checks 
thierryjc11: bets €0.04
ROGER20220: folds 
Safakab: folds 
Uncalled bet (€0.04) returned to thierryjc11
thierryjc11 collected €0.06 from pot
thierryjc11: doesn't show hand 
*** SUMMARY ***
Total pot €0.06 | Rake €0 
Board [7c 4c Qc]
Seat 1: DoBrazil folded before Flop (didn't bet)
Seat 2: thierryjc11 (button) collected (€0.06)
Seat 3: ROGER20220 (small blind) folded on the Flop
Seat 4: Safakab (big blind) folded on the Flop
Seat 5: mikrethor folded before Flop (didn't bet)
Seat 6: maximo5565 folded before Flop (didn't bet)



PokerStars Hand #109567718979:  Hold'em No Limit (€0.01/€0.02 EUR) - 2014/01/04 14:22:02 CET [2014/01/04 8:22:02 ET]
Table 'Ambrosia III' 6-max Seat #3 is the button
Seat 1: DoBrazil (€2.63 in chips) 
Seat 2: thierryjc11 (€1.50 in chips) 
Seat 3: ROGER20220 (€1.13 in chips) 
Seat 4: Safakab (€2.25 in chips) 
Seat 5: mikrethor (€3.10 in chips) 
Safakab: posts small blind €0.01
mikrethor: posts big blind €0.02
*** HOLE CARDS ***
Dealt to mikrethor [3c 3d]
DoBrazil: folds 
thierryjc11: calls €0.02
ROGER20220: raises €0.14 to €0.16
Safakab: folds 
mikrethor: folds 
thierryjc11: folds 
Uncalled bet (€0.14) returned to ROGER20220
ROGER20220 collected €0.07 from pot
ROGER20220: doesn't show hand 
*** SUMMARY ***
Total pot €0.07 | Rake €0 
Seat 1: DoBrazil folded before Flop (didn't bet)
Seat 2: thierryjc11 folded before Flop
Seat 3: ROGER20220 (button) collected (€0.07)
Seat 4: Safakab (small blind) folded before Flop
Seat 5: mikrethor (big blind) folded before Flop



PokerStars Hand #109567731449:  Hold'em No Limit (€0.01/€0.02 EUR) - 2014/01/04 14:22:20 CET [2014/01/04 8:22:20 ET]
Table 'Ambrosia III' 6-max Seat #4 is the button
Seat 1: DoBrazil (€2.63 in chips) 
Seat 2: thierryjc11 (€1.48 in chips) 
Seat 3: ROGER20220 (€1.18 in chips) 
Seat 4: Safakab (€2.24 in chips) 
Seat 5: mikrethor (€3.08 in chips) 
mikrethor: posts small blind €0.01
DoBrazil: posts big blind €0.02
*** HOLE CARDS ***
Dealt to mikrethor [8s 6c]
thierryjc11: calls €0.02
ROGER20220: folds 
Safakab: folds 
mikrethor: folds 
DoBrazil: checks 
*** FLOP *** [6h 2c 7c]
DoBrazil: checks 
thierryjc11: bets €0.04
DoBrazil: folds 
Uncalled bet (€0.04) returned to thierryjc11
thierryjc11 collected €0.05 from pot
thierryjc11: doesn't show hand 
*** SUMMARY ***
Total pot €0.05 | Rake €0 
Board [6h 2c 7c]
Seat 1: DoBrazil (big blind) folded on the Flop
Seat 2: thierryjc11 collected (€0.05)
Seat 3: ROGER20220 folded before Flop (didn't bet)
Seat 4: Safakab (button) folded before Flop (didn't bet)
Seat 5: mikrethor (small blind) folded before Flop



PokerStars Hand #109567744673:  Hold'em No Limit (€0.01/€0.02 EUR) - 2014/01/04 14:22:38 CET [2014/01/04 8:22:38 ET]
Table 'Ambrosia III' 6-max Seat #5 is the button
Seat 1: DoBrazil (€2.61 in chips) 
Seat 2: thierryjc11 (€1.51 in chips) 
Seat 3: ROGER20220 (€1.18 in chips) 
Seat 4: Safakab (€2.24 in chips) 
Seat 5: mikrethor (€3.07 in chips) 
DoBrazil: posts small blind €0.01
thierryjc11: posts big blind €0.02
*** HOLE CARDS ***
Dealt to mikrethor [5s Qs]
ROGER20220: calls €0.02
Safakab: folds 
mikrethor: calls €0.02
DoBrazil: calls €0.01
thierryjc11: checks 
*** FLOP *** [8s 9d Jd]
DoBrazil: checks 
thierryjc11: checks 
ROGER20220: checks 
mikrethor: checks 
*** TURN *** [8s 9d Jd] [Th]
DoBrazil: checks 
thierryjc11: checks 
ROGER20220: bets €0.06
mikrethor: calls €0.06
DoBrazil: folds 
thierryjc11: folds 
*** RIVER *** [8s 9d Jd Th] [Jc]
ROGER20220: bets €0.08
mikrethor: raises €0.08 to €0.16
ROGER20220: calls €0.08
*** SHOW DOWN ***
mikrethor: shows [5s Qs] (a straight, Eight to Queen)
ROGER20220: shows [4h Qh] (a straight, Eight to Queen)
ROGER20220 collected €0.25 from pot
mikrethor collected €0.24 from pot
*** SUMMARY ***
Total pot €0.52 | Rake €0.03 
Board [8s 9d Jd Th Jc]
Seat 1: DoBrazil (small blind) folded on the Turn
Seat 2: thierryjc11 (big blind) folded on the Turn
Seat 3: ROGER20220 showed [4h Qh] and won (€0.25) with a straight, Eight to Queen
Seat 4: Safakab folded before Flop (didn't bet)
Seat 5: mikrethor (button) showed [5s Qs] and won (€0.24) with a straight, Eight to Queen



PokerStars Hand #109567772959:  Hold'em No Limit (€0.01/€0.02 EUR) - 2014/01/04 14:23:18 CET [2014/01/04 8:23:18 ET]
Table 'Ambrosia III' 6-max Seat #1 is the button
Seat 1: DoBrazil (€2.59 in chips) 
Seat 2: thierryjc11 (€1.49 in chips) 
Seat 3: ROGER20220 (€1.19 in chips) 
Seat 4: Safakab (€2.24 in chips) 
Seat 5: mikrethor (€3.07 in chips) 
thierryjc11: posts small blind €0.01
ROGER20220: posts big blind €0.02
*** HOLE CARDS ***
Dealt to mikrethor [7s Th]
Safakab: folds 
mikrethor: folds 
DoBrazil: folds 
thierryjc11: calls €0.01
ROGER20220: checks 
*** FLOP *** [7d Qd 5d]
thierryjc11: bets €0.04
ROGER20220: folds 
Uncalled bet (€0.04) returned to thierryjc11
thierryjc11 collected €0.04 from pot
thierryjc11: doesn't show hand 
*** SUMMARY ***
Total pot €0.04 | Rake €0 
Board [7d Qd 5d]
Seat 1: DoBrazil (button) folded before Flop (didn't bet)
Seat 2: thierryjc11 (small blind) collected (€0.04)
Seat 3: ROGER20220 (big blind) folded on the Flop
Seat 4: Safakab folded before Flop (didn't bet)
Seat 5: mikrethor folded before Flop (didn't bet)



PokerStars Hand #109567786354:  Hold'em No Limit (€0.01/€0.02 EUR) - 2014/01/04 14:23:37 CET [2014/01/04 8:23:37 ET]
Table 'Ambrosia III' 6-max Seat #2 is the button
Seat 1: DoBrazil (€2.59 in chips) 
Seat 2: thierryjc11 (€1.51 in chips) 
Seat 3: ROGER20220 (€1.17 in chips) 
Seat 4: Safakab (€2.24 in chips) 
Seat 5: mikrethor (€3.07 in chips) 
ROGER20220: posts small blind €0.01
Safakab: posts big blind €0.02
*** HOLE CARDS ***
Dealt to mikrethor [3s Js]
mikrethor: folds 
DoBrazil: raises €0.06 to €0.08
thierryjc11: calls €0.08
ROGER20220: calls €0.07
Safakab: calls €0.06
*** FLOP *** [Ad Ks 5h]
ROGER20220: checks 
Safakab: bets €0.08
DoBrazil: folds 
thierryjc11: folds 
ROGER20220: calls €0.08
*** TURN *** [Ad Ks 5h] [Jd]
ROGER20220: checks 
Safakab: bets €0.25
ROGER20220: folds 
Uncalled bet (€0.25) returned to Safakab
Safakab collected €0.45 from pot
Safakab: doesn't show hand 
*** SUMMARY ***
Total pot €0.48 | Rake €0.03 
Board [Ad Ks 5h Jd]
Seat 1: DoBrazil folded on the Flop
Seat 2: thierryjc11 (button) folded on the Flop
Seat 3: ROGER20220 (small blind) folded on the Turn
Seat 4: Safakab (big blind) collected (€0.45)
Seat 5: mikrethor folded before Flop (didn't bet)



PokerStars Hand #109567818423:  Hold'em No Limit (€0.01/€0.02 EUR) - 2014/01/04 14:24:22 CET [2014/01/04 8:24:22 ET]
Table 'Ambrosia III' 6-max Seat #3 is the button
Seat 1: DoBrazil (€2.51 in chips) 
Seat 2: thierryjc11 (€1.43 in chips) 
Seat 3: ROGER20220 (€1.01 in chips) 
Seat 4: Safakab (€2.53 in chips) 
Seat 5: mikrethor (€3.07 in chips) 
Safakab: posts small blind €0.01
mikrethor: posts big blind €0.02
*** HOLE CARDS ***
Dealt to mikrethor [Qd 8c]
DoBrazil: calls €0.02
thierryjc11: calls €0.02
ROGER20220: raises €0.12 to €0.14
Safakab: folds 
mikrethor: folds 
DoBrazil: folds 
thierryjc11: folds 
Uncalled bet (€0.12) returned to ROGER20220
ROGER20220 collected €0.09 from pot
ROGER20220: doesn't show hand 
*** SUMMARY ***
Total pot €0.09 | Rake €0 
Seat 1: DoBrazil folded before Flop
Seat 2: thierryjc11 folded before Flop
Seat 3: ROGER20220 (button) collected (€0.09)
Seat 4: Safakab (small blind) folded before Flop
Seat 5: mikrethor (big blind) folded before Flop



PokerStars Hand #109567835583:  Hold'em No Limit (€0.01/€0.02 EUR) - 2014/01/04 14:24:46 CET [2014/01/04 8:24:46 ET]
Table 'Ambrosia III' 6-max Seat #4 is the button
Seat 1: DoBrazil (€2.49 in chips) 
Seat 2: thierryjc11 (€1.41 in chips) 
Seat 3: ROGER20220 (€1.08 in chips) 
Seat 4: Safakab (€2.52 in chips) 
Seat 5: mikrethor (€3.05 in chips) 
mikrethor: posts small blind €0.01
DoBrazil: posts big blind €0.02
*** HOLE CARDS ***
Dealt to mikrethor [2c 7c]
thierryjc11: calls €0.02
ROGER20220: raises €0.02 to €0.04
Safakab: calls €0.04
mikrethor: folds 
DoBrazil: calls €0.02
thierryjc11: calls €0.02
*** FLOP *** [As Qh 4s]
DoBrazil: checks 
thierryjc11: checks 
ROGER20220: checks 
Safakab: bets €0.08
DoBrazil: folds 
thierryjc11: folds 
ROGER20220: folds 
Uncalled bet (€0.08) returned to Safakab
ns68000 joins the table at seat #6 
Safakab collected €0.16 from pot
Safakab: doesn't show hand 
*** SUMMARY ***
Total pot €0.17 | Rake €0.01 
Board [As Qh 4s]
Seat 1: DoBrazil (big blind) folded on the Flop
Seat 2: thierryjc11 folded on the Flop
Seat 3: ROGER20220 folded on the Flop
Seat 4: Safakab (button) collected (€0.16)
Seat 5: mikrethor (small blind) folded before Flop



PokerStars Hand #109567852937:  Hold'em No Limit (€0.01/€0.02 EUR) - 2014/01/04 14:25:11 CET [2014/01/04 8:25:11 ET]
Table 'Ambrosia III' 6-max Seat #5 is the button
Seat 1: DoBrazil (€2.45 in chips) 
Seat 2: thierryjc11 (€1.37 in chips) 
Seat 3: ROGER20220 (€1.04 in chips) 
Seat 4: Safakab (€2.64 in chips) 
Seat 5: mikrethor (€3.04 in chips) 
ns68000 will be allowed to play after the button
DoBrazil: posts small blind €0.01
thierryjc11: posts big blind €0.02
*** HOLE CARDS ***
Dealt to mikrethor [Td 8h]
ROGER20220: calls €0.02
Safakab: folds 
mikrethor: folds 
DoBrazil: folds 
thierryjc11: checks 
*** FLOP *** [4s Ks Js]
thierryjc11: bets €0.04
ROGER20220: raises €0.04 to €0.08
thierryjc11: calls €0.04
*** TURN *** [4s Ks Js] [7c]
thierryjc11: checks 
ROGER20220: bets €0.06
thierryjc11: calls €0.06
*** RIVER *** [4s Ks Js 7c] [8d]
thierryjc11: checks 
ROGER20220: bets €0.08
thierryjc11: folds 
Uncalled bet (€0.08) returned to ROGER20220
ROGER20220 collected €0.31 from pot
ROGER20220: doesn't show hand 
*** SUMMARY ***
Total pot €0.33 | Rake €0.02 
Board [4s Ks Js 7c 8d]
Seat 1: DoBrazil (small blind) folded before Flop
Seat 2: thierryjc11 (big blind) folded on the River
Seat 3: ROGER20220 collected (€0.31)
Seat 4: Safakab folded before Flop (didn't bet)
Seat 5: mikrethor (button) folded before Flop (didn't bet)



PokerStars Hand #109567886646:  Hold'em No Limit (€0.01/€0.02 EUR) - 2014/01/04 14:25:58 CET [2014/01/04 8:25:58 ET]
Table 'Ambrosia III' 6-max Seat #1 is the button
Seat 1: DoBrazil (€2.44 in chips) 
Seat 2: thierryjc11 (€1.21 in chips) 
Seat 3: ROGER20220 (€1.19 in chips) 
Seat 4: Safakab (€2.64 in chips) 
Seat 5: mikrethor (€3.04 in chips) 
Seat 6: ns68000 (€1 in chips) 
thierryjc11: posts small blind €0.01
ROGER20220: posts big blind €0.02
ns68000: posts big blind €0.02
*** HOLE CARDS ***
Dealt to mikrethor [8h 2h]
Safakab: folds 
mikrethor: folds 
ns68000: checks 
DoBrazil: calls €0.02
thierryjc11: calls €0.01
ROGER20220: checks 
*** FLOP *** [6s 5s 2c]
thierryjc11: bets €0.02
ROGER20220: calls €0.02
ns68000: calls €0.02
DoBrazil: folds 
*** TURN *** [6s 5s 2c] [9c]
thierryjc11: bets €0.02
ROGER20220: calls €0.02
ns68000: calls €0.02
*** RIVER *** [6s 5s 2c 9c] [8c]
thierryjc11: bets €0.04
ROGER20220: folds 
ns68000: folds 
Uncalled bet (€0.04) returned to thierryjc11
thierryjc11 collected €0.19 from pot
thierryjc11: doesn't show hand 
*** SUMMARY ***
Total pot €0.20 | Rake €0.01 
Board [6s 5s 2c 9c 8c]
Seat 1: DoBrazil (button) folded on the Flop
Seat 2: thierryjc11 (small blind) collected (€0.19)
Seat 3: ROGER20220 (big blind) folded on the River
Seat 4: Safakab folded before Flop (didn't bet)
Seat 5: mikrethor folded before Flop (didn't bet)
Seat 6: ns68000 folded on the River



PokerStars Hand #109567920935:  Hold'em No Limit (€0.01/€0.02 EUR) - 2014/01/04 14:26:46 CET [2014/01/04 8:26:46 ET]
Table 'Ambrosia III' 6-max Seat #2 is the button
Seat 1: DoBrazil (€2.42 in chips) 
Seat 2: thierryjc11 (€1.34 in chips) 
Seat 3: ROGER20220 (€1.13 in chips) 
Seat 4: Safakab (€2.64 in chips) 
Seat 5: mikrethor (€3.04 in chips) 
Seat 6: ns68000 (€0.94 in chips) 
ROGER20220: posts small blind €0.01
Safakab: posts big blind €0.02
*** HOLE CARDS ***
Dealt to mikrethor [Ts 6c]
mikrethor: folds 
ns68000: folds 
DoBrazil: folds 
thierryjc11: calls €0.02
ROGER20220: calls €0.01
Safakab: checks 
*** FLOP *** [7h 8h 8c]
ROGER20220: checks 
Safakab: checks 
thierryjc11: bets €0.04
ROGER20220: calls €0.04
Safakab: calls €0.04
*** TURN *** [7h 8h 8c] [7c]
ROGER20220: checks 
Safakab: checks 
thierryjc11: checks 
*** RIVER *** [7h 8h 8c 7c] [As]
ROGER20220: checks 
Safakab: bets €0.13
thierryjc11: folds 
ROGER20220: folds 
Uncalled bet (€0.13) returned to Safakab
Safakab collected €0.17 from pot
Safakab: doesn't show hand 
*** SUMMARY ***
Total pot €0.18 | Rake €0.01 
Board [7h 8h 8c 7c As]
Seat 1: DoBrazil folded before Flop (didn't bet)
Seat 2: thierryjc11 (button) folded on the River
Seat 3: ROGER20220 (small blind) folded on the River
Seat 4: Safakab (big blind) collected (€0.17)
Seat 5: mikrethor folded before Flop (didn't bet)
Seat 6: ns68000 folded before Flop (didn't bet)



PokerStars Hand #109567974552:  Hold'em No Limit (€0.01/€0.02 EUR) - 2014/01/04 14:28:00 CET [2014/01/04 8:28:00 ET]
Table 'Ambrosia III' 6-max Seat #3 is the button
Seat 1: DoBrazil (€2.42 in chips) 
Seat 2: thierryjc11 (€1.28 in chips) 
Seat 3: ROGER20220 (€1.07 in chips) 
Seat 4: Safakab (€2.75 in chips) 
Seat 5: mikrethor (€3.04 in chips) 
Seat 6: ns68000 (€0.94 in chips) 
Safakab: posts small blind €0.01
mikrethor: posts big blind €0.02
*** HOLE CARDS ***
Dealt to mikrethor [8s Tc]
ns68000: folds 
DoBrazil: raises €0.06 to €0.08
thierryjc11: folds 
ROGER20220: raises €0.08 to €0.16
Safakab: calls €0.15
mikrethor: folds 
DoBrazil: calls €0.08
*** FLOP *** [8h 3d 3c]
Safakab: checks 
DoBrazil: checks 
ROGER20220: bets €0.14
Safakab: calls €0.14
DoBrazil: folds 
*** TURN *** [8h 3d 3c] [Ah]
Safakab: checks 
ROGER20220: bets €0.77 and is all-in
Safakab: folds 
Uncalled bet (€0.77) returned to ROGER20220
ROGER20220 collected €0.73 from pot
ROGER20220: doesn't show hand 
*** SUMMARY ***
Total pot €0.78 | Rake €0.05 
Board [8h 3d 3c Ah]
Seat 1: DoBrazil folded on the Flop
Seat 2: thierryjc11 folded before Flop (didn't bet)
Seat 3: ROGER20220 (button) collected (€0.73)
Seat 4: Safakab (small blind) folded on the Turn
Seat 5: mikrethor (big blind) folded before Flop
Seat 6: ns68000 folded before Flop (didn't bet)



PokerStars Hand #109568009748:  Hold'em No Limit (€0.01/€0.02 EUR) - 2014/01/04 14:28:49 CET [2014/01/04 8:28:49 ET]
Table 'Ambrosia III' 6-max Seat #4 is the button
Seat 1: DoBrazil (€2.26 in chips) 
Seat 2: thierryjc11 (€1.28 in chips) 
Seat 3: ROGER20220 (€1.50 in chips) 
Seat 4: Safakab (€2.45 in chips) 
Seat 5: mikrethor (€3.02 in chips) 
Seat 6: ns68000 (€0.94 in chips) 
mikrethor: posts small blind €0.01
ns68000: posts big blind €0.02
*** HOLE CARDS ***
Dealt to mikrethor [7h Td]
DoBrazil: folds 
thierryjc11: folds 
ROGER20220: raises €0.06 to €0.08
Safakab: calls €0.08
mikrethor: folds 
ns68000: folds 
*** FLOP *** [Qc 4s As]
ROGER20220: bets €0.06
Safakab: calls €0.06
*** TURN *** [Qc 4s As] [2s]
ROGER20220: bets €0.06
Safakab: calls €0.06
*** RIVER *** [Qc 4s As 2s] [Kh]
ROGER20220: bets €0.20
Safakab: calls €0.20
*** SHOW DOWN ***
ROGER20220: shows [Js Jd] (a pair of Jacks)
Safakab: shows [Ad 5d] (a pair of Aces)
Safakab collected €0.78 from pot
*** SUMMARY ***
Total pot €0.83 | Rake €0.05 
Board [Qc 4s As 2s Kh]
Seat 1: DoBrazil folded before Flop (didn't bet)
Seat 2: thierryjc11 folded before Flop (didn't bet)
Seat 3: ROGER20220 showed [Js Jd] and lost with a pair of Jacks
Seat 4: Safakab (button) showed [Ad 5d] and won (€0.78) with a pair of Aces
Seat 5: mikrethor (small blind) folded before Flop
Seat 6: ns68000 (big blind) folded before Flop



PokerStars Hand #109568058222:  Hold'em No Limit (€0.01/€0.02 EUR) - 2014/01/04 14:29:57 CET [2014/01/04 8:29:57 ET]
Table 'Ambrosia III' 6-max Seat #5 is the button
Seat 1: DoBrazil (€2.26 in chips) 
Seat 2: thierryjc11 (€1.28 in chips) 
Seat 3: ROGER20220 (€1.10 in chips) 
Seat 4: Safakab (€2.83 in chips) 
Seat 5: mikrethor (€3.01 in chips) 
Seat 6: ns68000 (€0.92 in chips) 
ns68000: posts small blind €0.01
DoBrazil: posts big blind €0.02
*** HOLE CARDS ***
Dealt to mikrethor [3c 7d]
thierryjc11: calls €0.02
ROGER20220: raises €0.08 to €0.10
Safakab: calls €0.10
mikrethor: folds 
ns68000: folds 
DoBrazil: folds 
thierryjc11: folds 
*** FLOP *** [2h 3s 9h]
ROGER20220: checks 
Safakab: bets €0.13
ROGER20220: calls €0.13
*** TURN *** [2h 3s 9h] [Kc]
ROGER20220: checks 
Safakab: checks 
*** RIVER *** [2h 3s 9h Kc] [8h]
ROGER20220: bets €0.10
Safakab: calls €0.10
*** SHOW DOWN ***
ROGER20220: shows [Qs Ks] (a pair of Kings)
Safakab: mucks hand 
ROGER20220 collected €0.67 from pot
*** SUMMARY ***
Total pot €0.71 | Rake €0.04 
Board [2h 3s 9h Kc 8h]
Seat 1: DoBrazil (big blind) folded before Flop
Seat 2: thierryjc11 folded before Flop
Seat 3: ROGER20220 showed [Qs Ks] and won (€0.67) with a pair of Kings
Seat 4: Safakab mucked [Jh As]
Seat 5: mikrethor (button) folded before Flop (didn't bet)
Seat 6: ns68000 (small blind) folded before Flop



PokerStars Hand #109568088829:  Hold'em No Limit (€0.01/€0.02 EUR) - 2014/01/04 14:30:39 CET [2014/01/04 8:30:39 ET]
Table 'Ambrosia III' 6-max Seat #6 is the button
Seat 1: DoBrazil (€2.24 in chips) 
Seat 2: thierryjc11 (€1.26 in chips) 
Seat 3: ROGER20220 (€1.44 in chips) 
Seat 4: Safakab (€2.50 in chips) 
Seat 5: mikrethor (€3.01 in chips) 
Seat 6: ns68000 (€0.91 in chips) 
DoBrazil: posts small blind €0.01
thierryjc11: posts big blind €0.02
*** HOLE CARDS ***
Dealt to mikrethor [5s 7h]
ROGER20220: folds 
Safakab: folds 
mikrethor: folds 
ns68000: folds 
DoBrazil: calls €0.01
thierryjc11: checks 
*** FLOP *** [7s 4c 5h]
DoBrazil: checks 
ROGER20220 said, "ON S AMUSE BIEN"
thierryjc11: bets €0.04
DoBrazil: folds 
Uncalled bet (€0.04) returned to thierryjc11
thierryjc11 collected €0.04 from pot
thierryjc11: doesn't show hand 
*** SUMMARY ***
Total pot €0.04 | Rake €0 
Board [7s 4c 5h]
Seat 1: DoBrazil (small blind) folded on the Flop
Seat 2: thierryjc11 (big blind) collected (€0.04)
Seat 3: ROGER20220 folded before Flop (didn't bet)
Seat 4: Safakab folded before Flop (didn't bet)
Seat 5: mikrethor folded before Flop (didn't bet)
Seat 6: ns68000 (button) folded before Flop (didn't bet)



PokerStars Hand #109568108213:  Hold'em No Limit (€0.01/€0.02 EUR) - 2014/01/04 14:31:06 CET [2014/01/04 8:31:06 ET]
Table 'Ambrosia III' 6-max Seat #1 is the button
Seat 1: DoBrazil (€2.22 in chips) 
Seat 2: thierryjc11 (€1.28 in chips) 
Seat 3: ROGER20220 (€1.44 in chips) 
Seat 4: Safakab (€2.50 in chips) 
Seat 5: mikrethor (€3.01 in chips) 
Seat 6: ns68000 (€0.91 in chips) 
thierryjc11: posts small blind €0.01
ROGER20220: posts big blind €0.02
*** HOLE CARDS ***
Dealt to mikrethor [Ks 8c]
Safakab: folds 
mikrethor: folds 
ns68000: folds 
DoBrazil: raises €0.06 to €0.08
thierryjc11: folds 
ROGER20220: calls €0.06
*** FLOP *** [3c 2d 8h]
ROGER20220: checks 
DoBrazil: bets €0.10
ROGER20220: folds 
Uncalled bet (€0.10) returned to DoBrazil
DoBrazil collected €0.16 from pot
*** SUMMARY ***
Total pot €0.17 | Rake €0.01 
Board [3c 2d 8h]
Seat 1: DoBrazil (button) collected (€0.16)
Seat 2: thierryjc11 (small blind) folded before Flop
Seat 3: ROGER20220 (big blind) folded on the Flop
Seat 4: Safakab folded before Flop (didn't bet)
Seat 5: mikrethor folded before Flop (didn't bet)
Seat 6: ns68000 folded before Flop (didn't bet)



PokerStars Hand #109568133599:  Hold'em No Limit (€0.01/€0.02 EUR) - 2014/01/04 14:31:42 CET [2014/01/04 8:31:42 ET]
Table 'Ambrosia III' 6-max Seat #2 is the button
Seat 1: DoBrazil (€2.30 in chips) 
Seat 2: thierryjc11 (€1.27 in chips) 
Seat 3: ROGER20220 (€1.36 in chips) 
Seat 4: Safakab (€2.50 in chips) 
Seat 5: mikrethor (€3.01 in chips) 
Seat 6: ns68000 (€0.91 in chips) 
ROGER20220: posts small blind €0.01
Safakab: posts big blind €0.02
*** HOLE CARDS ***
Dealt to mikrethor [2d 4c]
mikrethor: folds 
ns68000: folds 
DoBrazil: folds 
thierryjc11: calls €0.02
ROGER20220: calls €0.01
Safakab: raises €0.06 to €0.08
thierryjc11: folds 
ROGER20220: folds 
Uncalled bet (€0.06) returned to Safakab
Safakab collected €0.06 from pot
Safakab: doesn't show hand 
*** SUMMARY ***
Total pot €0.06 | Rake €0 
Seat 1: DoBrazil folded before Flop (didn't bet)
Seat 2: thierryjc11 (button) folded before Flop
Seat 3: ROGER20220 (small blind) folded before Flop
Seat 4: Safakab (big blind) collected (€0.06)
Seat 5: mikrethor folded before Flop (didn't bet)
Seat 6: ns68000 folded before Flop (didn't bet)



PokerStars Hand #109568148863:  Hold'em No Limit (€0.01/€0.02 EUR) - 2014/01/04 14:32:03 CET [2014/01/04 8:32:03 ET]
Table 'Ambrosia III' 6-max Seat #3 is the button
Seat 1: DoBrazil (€2.30 in chips) 
Seat 2: thierryjc11 (€1.25 in chips) 
Seat 3: ROGER20220 (€1.34 in chips) 
Seat 4: Safakab (€2.54 in chips) 
Seat 5: mikrethor (€3.01 in chips) 
Seat 6: ns68000 (€0.91 in chips) 
Safakab: posts small blind €0.01
mikrethor: posts big blind €0.02
*** HOLE CARDS ***
Dealt to mikrethor [5h Kc]
ns68000: calls €0.02
DoBrazil: raises €0.08 to €0.10
thierryjc11: folds 
ROGER20220: folds 
Safakab: folds 
mikrethor: folds 
ns68000: calls €0.08
*** FLOP *** [5d Ks Ad]
ns68000: checks 
DoBrazil: checks 
*** TURN *** [5d Ks Ad] [3s]
ns68000: checks 
DoBrazil: checks 
*** RIVER *** [5d Ks Ad 3s] [8s]
ns68000: bets €0.22
DoBrazil: folds 
Uncalled bet (€0.22) returned to ns68000
ns68000 collected €0.22 from pot
ns68000: doesn't show hand 
*** SUMMARY ***
Total pot €0.23 | Rake €0.01 
Board [5d Ks Ad 3s 8s]
Seat 1: DoBrazil folded on the River
Seat 2: thierryjc11 folded before Flop (didn't bet)
Seat 3: ROGER20220 (button) folded before Flop (didn't bet)
Seat 4: Safakab (small blind) folded before Flop
Seat 5: mikrethor (big blind) folded before Flop
Seat 6: ns68000 collected (€0.22)



PokerStars Hand #109568176260:  Hold'em No Limit (€0.01/€0.02 EUR) - 2014/01/04 14:32:41 CET [2014/01/04 8:32:41 ET]
Table 'Ambrosia III' 6-max Seat #4 is the button
Seat 1: DoBrazil (€2.20 in chips) 
Seat 2: thierryjc11 (€1.25 in chips) 
Seat 3: ROGER20220 (€1.34 in chips) 
Seat 4: Safakab (€2.53 in chips) 
Seat 5: mikrethor (€2.99 in chips) 
Seat 6: ns68000 (€1.03 in chips) 
mikrethor: posts small blind €0.01
ns68000: posts big blind €0.02
*** HOLE CARDS ***
Dealt to mikrethor [5c 2h]
DoBrazil: folds 
thierryjc11: folds 
ROGER20220: folds 
Safakab: raises €0.06 to €0.08
mikrethor: folds 
ns68000: folds 
Uncalled bet (€0.06) returned to Safakab
Safakab collected €0.05 from pot
Safakab: doesn't show hand 
*** SUMMARY ***
Total pot €0.05 | Rake €0 
Seat 1: DoBrazil folded before Flop (didn't bet)
Seat 2: thierryjc11 folded before Flop (didn't bet)
Seat 3: ROGER20220 folded before Flop (didn't bet)
Seat 4: Safakab (button) collected (€0.05)
Seat 5: mikrethor (small blind) folded before Flop
Seat 6: ns68000 (big blind) folded before Flop



PokerStars Hand #109568185113:  Hold'em No Limit (€0.01/€0.02 EUR) - 2014/01/04 14:32:54 CET [2014/01/04 8:32:54 ET]
Table 'Ambrosia III' 6-max Seat #5 is the button
Seat 1: DoBrazil (€2.20 in chips) 
Seat 2: thierryjc11 (€1.25 in chips) 
Seat 3: ROGER20220 (€1.34 in chips) 
Seat 4: Safakab (€2.56 in chips) 
Seat 5: mikrethor (€2.98 in chips) 
Seat 6: ns68000 (€1.01 in chips) 
ns68000: posts small blind €0.01
DoBrazil: posts big blind €0.02
*** HOLE CARDS ***
Dealt to mikrethor [8s 5d]
thierryjc11: folds 
ROGER20220: raises €0.04 to €0.06
Safakab: folds 
mikrethor: folds 
ns68000: folds 
DoBrazil: folds 
Uncalled bet (€0.04) returned to ROGER20220
ROGER20220 collected €0.05 from pot
ROGER20220: doesn't show hand 
*** SUMMARY ***
Total pot €0.05 | Rake €0 
Seat 1: DoBrazil (big blind) folded before Flop
Seat 2: thierryjc11 folded before Flop (didn't bet)
Seat 3: ROGER20220 collected (€0.05)
Seat 4: Safakab folded before Flop (didn't bet)
Seat 5: mikrethor (button) folded before Flop (didn't bet)
Seat 6: ns68000 (small blind) folded before Flop



PokerStars Hand #109568204096:  Hold'em No Limit (€0.01/€0.02 EUR) - 2014/01/04 14:33:20 CET [2014/01/04 8:33:20 ET]
Table 'Ambrosia III' 6-max Seat #6 is the button
Seat 1: DoBrazil (€2.18 in chips) 
Seat 2: thierryjc11 (€1.25 in chips) 
Seat 3: ROGER20220 (€1.37 in chips) 
Seat 4: Safakab (€2.56 in chips) 
Seat 5: mikrethor (€2.98 in chips) 
Seat 6: ns68000 (€1 in chips) 
DoBrazil: posts small blind €0.01
thierryjc11: posts big blind €0.02
*** HOLE CARDS ***
Dealt to mikrethor [8d 2s]
ROGER20220: folds 
Safakab: raises €0.06 to €0.08
mikrethor: folds 
ns68000: folds 
DoBrazil: folds 
thierryjc11: folds 
Uncalled bet (€0.06) returned to Safakab
Safakab collected €0.05 from pot
Safakab: doesn't show hand 
*** SUMMARY ***
Total pot €0.05 | Rake €0 
Seat 1: DoBrazil (small blind) folded before Flop
Seat 2: thierryjc11 (big blind) folded before Flop
Seat 3: ROGER20220 folded before Flop (didn't bet)
Seat 4: Safakab collected (€0.05)
Seat 5: mikrethor folded before Flop (didn't bet)
Seat 6: ns68000 (button) folded before Flop (didn't bet)



PokerStars Hand #109568213364:  Hold'em No Limit (€0.01/€0.02 EUR) - 2014/01/04 14:33:34 CET [2014/01/04 8:33:34 ET]
Table 'Ambrosia III' 6-max Seat #1 is the button
Seat 1: DoBrazil (€2.17 in chips) 
Seat 2: thierryjc11 (€1.23 in chips) 
Seat 3: ROGER20220 (€1.37 in chips) 
Seat 4: Safakab (€2.59 in chips) 
Seat 5: mikrethor (€2.98 in chips) 
Seat 6: ns68000 (€1 in chips) 
thierryjc11: posts small blind €0.01
ROGER20220: posts big blind €0.02
*** HOLE CARDS ***
Dealt to mikrethor [3c Qc]
Safakab: folds 
mikrethor: raises €0.06 to €0.08
ns68000: folds 
DoBrazil: folds 
thierryjc11: folds 
ROGER20220: calls €0.06
*** FLOP *** [Ks Kh Jd]
ROGER20220: bets €0.14
mikrethor: folds 
Uncalled bet (€0.14) returned to ROGER20220
ROGER20220 collected €0.16 from pot
ROGER20220: doesn't show hand 
*** SUMMARY ***
Total pot €0.17 | Rake €0.01 
Board [Ks Kh Jd]
Seat 1: DoBrazil (button) folded before Flop (didn't bet)
Seat 2: thierryjc11 (small blind) folded before Flop
Seat 3: ROGER20220 (big blind) collected (€0.16)
Seat 4: Safakab folded before Flop (didn't bet)
Seat 5: mikrethor folded on the Flop
Seat 6: ns68000 folded before Flop (didn't bet)



PokerStars Hand #109568239289:  Hold'em No Limit (€0.01/€0.02 EUR) - 2014/01/04 14:34:10 CET [2014/01/04 8:34:10 ET]
Table 'Ambrosia III' 6-max Seat #2 is the button
Seat 1: DoBrazil (€2.17 in chips) 
Seat 2: thierryjc11 (€1.22 in chips) 
Seat 3: ROGER20220 (€1.45 in chips) 
Seat 4: Safakab (€2.59 in chips) 
Seat 5: mikrethor (€2.90 in chips) 
Seat 6: ns68000 (€1 in chips) 
ROGER20220: posts small blind €0.01
Safakab: posts big blind €0.02
*** HOLE CARDS ***
Dealt to mikrethor [Jd Th]
mikrethor: calls €0.02
ns68000: calls €0.02
DoBrazil: folds 
thierryjc11: calls €0.02
ROGER20220: calls €0.01
Safakab: checks 
*** FLOP *** [2d Qd 6s]
ROGER20220: checks 
Safakab: checks 
mikrethor: checks 
ns68000: checks 
thierryjc11: bets €0.04
ROGER20220: folds 
Safakab: folds 
mikrethor: raises €0.04 to €0.08
ns68000: folds 
thierryjc11: folds 
Uncalled bet (€0.04) returned to mikrethor
mikrethor collected €0.17 from pot
mikrethor: doesn't show hand 
*** SUMMARY ***
Total pot €0.18 | Rake €0.01 
Board [2d Qd 6s]
Seat 1: DoBrazil folded before Flop (didn't bet)
Seat 2: thierryjc11 (button) folded on the Flop
Seat 3: ROGER20220 (small blind) folded on the Flop
Seat 4: Safakab (big blind) folded on the Flop
Seat 5: mikrethor collected (€0.17)
Seat 6: ns68000 folded on the Flop



PokerStars Hand #109568279236:  Hold'em No Limit (€0.01/€0.02 EUR) - 2014/01/04 14:35:06 CET [2014/01/04 8:35:06 ET]
Table 'Ambrosia III' 6-max Seat #3 is the button
Seat 1: DoBrazil (€2.17 in chips) 
Seat 2: thierryjc11 (€1.16 in chips) 
Seat 3: ROGER20220 (€1.43 in chips) 
Seat 4: Safakab (€2.57 in chips) 
Seat 5: mikrethor (€3.01 in chips) 
Seat 6: ns68000 (€0.98 in chips) 
Safakab: posts small blind €0.01
mikrethor: posts big blind €0.02
*** HOLE CARDS ***
Dealt to mikrethor [8d 2h]
ns68000: calls €0.02
DoBrazil: folds 
thierryjc11: calls €0.02
ROGER20220: calls €0.02
Safakab: raises €0.06 to €0.08
mikrethor: folds 
ns68000: calls €0.06
thierryjc11: folds 
ROGER20220: calls €0.06
*** FLOP *** [4d 5h 2s]
Safakab: checks 
ns68000: checks 
ROGER20220: checks 
*** TURN *** [4d 5h 2s] [6c]
Safakab: bets €0.23
ns68000: folds 
ROGER20220: folds 
Uncalled bet (€0.23) returned to Safakab
Safakab collected €0.26 from pot
Safakab: doesn't show hand 
*** SUMMARY ***
Total pot €0.28 | Rake €0.02 
Board [4d 5h 2s 6c]
Seat 1: DoBrazil folded before Flop (didn't bet)
Seat 2: thierryjc11 folded before Flop
Seat 3: ROGER20220 (button) folded on the Turn
Seat 4: Safakab (small blind) collected (€0.26)
Seat 5: mikrethor (big blind) folded before Flop
Seat 6: ns68000 folded on the Turn



PokerStars Hand #109568322054:  Hold'em No Limit (€0.01/€0.02 EUR) - 2014/01/04 14:36:05 CET [2014/01/04 8:36:05 ET]
Table 'Ambrosia III' 6-max Seat #4 is the button
Seat 1: DoBrazil (€2.17 in chips) 
Seat 2: thierryjc11 (€1.14 in chips) 
Seat 3: ROGER20220 (€1.35 in chips) 
Seat 4: Safakab (€2.75 in chips) 
Seat 5: mikrethor (€2.99 in chips) 
Seat 6: ns68000 (€0.90 in chips) 
mikrethor: posts small blind €0.01
ns68000: posts big blind €0.02
*** HOLE CARDS ***
Dealt to mikrethor [8c 3c]
DoBrazil: folds 
thierryjc11: folds 
ROGER20220: calls €0.02
Safakab: folds 
mikrethor: calls €0.01
ns68000: raises €0.04 to €0.06
ROGER20220: calls €0.04
mikrethor: calls €0.04
*** FLOP *** [2h 2d Ad]
mikrethor: checks 
ns68000: checks 
ROGER20220: checks 
*** TURN *** [2h 2d Ad] [4h]
mikrethor: checks 
ns68000: bets €0.08
ROGER20220: calls €0.08
mikrethor: folds 
*** RIVER *** [2h 2d Ad 4h] [Th]
ns68000: checks 
ROGER20220: checks 
*** SHOW DOWN ***
ns68000: shows [Ks Js] (a pair of Deuces)
ROGER20220: shows [Ac 3h] (two pair, Aces and Deuces)
ROGER20220 collected €0.32 from pot
*** SUMMARY ***
Total pot €0.34 | Rake €0.02 
Board [2h 2d Ad 4h Th]
Seat 1: DoBrazil folded before Flop (didn't bet)
Seat 2: thierryjc11 folded before Flop (didn't bet)
Seat 3: ROGER20220 showed [Ac 3h] and won (€0.32) with two pair, Aces and Deuces
Seat 4: Safakab (button) folded before Flop (didn't bet)
Seat 5: mikrethor (small blind) folded on the Turn
Seat 6: ns68000 (big blind) showed [Ks Js] and lost with a pair of Deuces



PokerStars Hand #109568355162:  Hold'em No Limit (€0.01/€0.02 EUR) - 2014/01/04 14:36:51 CET [2014/01/04 8:36:51 ET]
Table 'Ambrosia III' 6-max Seat #5 is the button
Seat 1: DoBrazil (€2.17 in chips) 
Seat 2: thierryjc11 (€1.14 in chips) 
Seat 3: ROGER20220 (€1.53 in chips) 
Seat 4: Safakab (€2.75 in chips) 
Seat 5: mikrethor (€2.93 in chips) 
Seat 6: ns68000 (€0.76 in chips) 
ns68000: posts small blind €0.01
DoBrazil: posts big blind €0.02
*** HOLE CARDS ***
Dealt to mikrethor [Ks 7d]
thierryjc11: calls €0.02
ROGER20220: calls €0.02
Safakab: folds 
mikrethor: folds 
ns68000: raises €0.04 to €0.06
DoBrazil: calls €0.04
thierryjc11: calls €0.04
ROGER20220: calls €0.04
*** FLOP *** [2c Td 9c]
ns68000: bets €0.70 and is all-in
DoBrazil: folds 
thierryjc11: folds 
ROGER20220: folds 
Uncalled bet (€0.70) returned to ns68000
ns68000 collected €0.23 from pot
*** SUMMARY ***
Total pot €0.24 | Rake €0.01 
Board [2c Td 9c]
Seat 1: DoBrazil (big blind) folded on the Flop
Seat 2: thierryjc11 folded on the Flop
Seat 3: ROGER20220 folded on the Flop
Seat 4: Safakab folded before Flop (didn't bet)
Seat 5: mikrethor (button) folded before Flop (didn't bet)
Seat 6: ns68000 (small blind) collected (€0.23)



PokerStars Hand #109568374560:  Hold'em No Limit (€0.01/€0.02 EUR) - 2014/01/04 14:37:18 CET [2014/01/04 8:37:18 ET]
Table 'Ambrosia III' 6-max Seat #6 is the button
Seat 1: DoBrazil (€2.11 in chips) 
Seat 2: thierryjc11 (€1.08 in chips) 
Seat 3: ROGER20220 (€1.47 in chips) 
Seat 4: Safakab (€2.75 in chips) 
Seat 5: mikrethor (€2.93 in chips) 
Seat 6: ns68000 (€0.93 in chips) 
DoBrazil: posts small blind €0.01
thierryjc11: posts big blind €0.02
*** HOLE CARDS ***
Dealt to mikrethor [Kd As]
ROGER20220: folds 
Safakab: folds 
mikrethor: raises €0.06 to €0.08
ns68000: folds 
DoBrazil: folds 
thierryjc11: folds 
Uncalled bet (€0.06) returned to mikrethor
mikrethor collected €0.05 from pot
mikrethor: doesn't show hand 
*** SUMMARY ***
Total pot €0.05 | Rake €0 
Seat 1: DoBrazil (small blind) folded before Flop
Seat 2: thierryjc11 (big blind) folded before Flop
Seat 3: ROGER20220 folded before Flop (didn't bet)
Seat 4: Safakab folded before Flop (didn't bet)
Seat 5: mikrethor collected (€0.05)
Seat 6: ns68000 (button) folded before Flop (didn't bet)



PokerStars Hand #109568398473:  Hold'em No Limit (€0.01/€0.02 EUR) - 2014/01/04 14:37:51 CET [2014/01/04 8:37:51 ET]
Table 'Ambrosia III' 6-max Seat #1 is the button
Seat 1: DoBrazil (€2.10 in chips) 
Seat 2: thierryjc11 (€1.06 in chips) 
Seat 3: ROGER20220 (€1.47 in chips) 
Seat 4: Safakab (€2.75 in chips) 
Seat 5: mikrethor (€2.96 in chips) 
Seat 6: ns68000 (€0.93 in chips) 
thierryjc11: posts small blind €0.01
ROGER20220: posts big blind €0.02
*** HOLE CARDS ***
Dealt to mikrethor [3h 6h]
Safakab: folds 
mikrethor: folds 
ns68000: calls €0.02
DoBrazil: folds 
thierryjc11: calls €0.01
ROGER20220: checks 
*** FLOP *** [5d Td Kd]
thierryjc11: checks 
ROGER20220: bets €0.06
ns68000: folds 
thierryjc11: folds 
Uncalled bet (€0.06) returned to ROGER20220
ROGER20220 collected €0.06 from pot
ROGER20220: doesn't show hand 
*** SUMMARY ***
Total pot €0.06 | Rake €0 
Board [5d Td Kd]
Seat 1: DoBrazil (button) folded before Flop (didn't bet)
Seat 2: thierryjc11 (small blind) folded on the Flop
Seat 3: ROGER20220 (big blind) collected (€0.06)
Seat 4: Safakab folded before Flop (didn't bet)
Seat 5: mikrethor folded before Flop (didn't bet)
Seat 6: ns68000 folded on the Flop



PokerStars Hand #109568415955:  Hold'em No Limit (€0.01/€0.02 EUR) - 2014/01/04 14:38:15 CET [2014/01/04 8:38:15 ET]
Table 'Ambrosia III' 6-max Seat #2 is the button
Seat 1: DoBrazil (€2.10 in chips) 
Seat 2: thierryjc11 (€1.04 in chips) 
Seat 3: ROGER20220 (€1.51 in chips) 
Seat 4: Safakab (€2.75 in chips) 
Seat 5: mikrethor (€2.96 in chips) 
Seat 6: ns68000 (€0.91 in chips) 
ROGER20220: posts small blind €0.01
Safakab: posts big blind €0.02
*** HOLE CARDS ***
Dealt to mikrethor [5h 9h]
mikrethor: folds 
ns68000: folds 
DoBrazil: folds 
thierryjc11: calls €0.02
ROGER20220: calls €0.01
Safakab: checks 
*** FLOP *** [9s 7h 2s]
ROGER20220: checks 
Safakab: checks 
thierryjc11: bets €0.04
ROGER20220: folds 
Safakab: folds 
Uncalled bet (€0.04) returned to thierryjc11
thierryjc11 collected €0.06 from pot
thierryjc11: doesn't show hand 
*** SUMMARY ***
Total pot €0.06 | Rake €0 
Board [9s 7h 2s]
Seat 1: DoBrazil folded before Flop (didn't bet)
Seat 2: thierryjc11 (button) collected (€0.06)
Seat 3: ROGER20220 (small blind) folded on the Flop
Seat 4: Safakab (big blind) folded on the Flop
Seat 5: mikrethor folded before Flop (didn't bet)
Seat 6: ns68000 folded before Flop (didn't bet)



PokerStars Hand #109568449060:  Hold'em No Limit (€0.01/€0.02 EUR) - 2014/01/04 14:39:00 CET [2014/01/04 8:39:00 ET]
Table 'Ambrosia III' 6-max Seat #3 is the button
Seat 1: DoBrazil (€2.10 in chips) 
Seat 2: thierryjc11 (€1.08 in chips) 
Seat 3: ROGER20220 (€1.49 in chips) 
Seat 4: Safakab (€2.73 in chips) 
Seat 5: mikrethor (€2.96 in chips) 
Seat 6: ns68000 (€0.91 in chips) 
Safakab: posts small blind €0.01
mikrethor: posts big blind €0.02
*** HOLE CARDS ***
Dealt to mikrethor [3d 5d]
ns68000: folds 
DoBrazil has timed out
DoBrazil: folds 
thierryjc11: calls €0.02
ROGER20220: folds 
Safakab: folds 
mikrethor: checks 
*** FLOP *** [9h Ts 6c]
mikrethor: checks 
thierryjc11: bets €0.04
mikrethor: folds 
Uncalled bet (€0.04) returned to thierryjc11
thierryjc11 collected €0.05 from pot
thierryjc11: doesn't show hand 
*** SUMMARY ***
Total pot €0.05 | Rake €0 
Board [9h Ts 6c]
Seat 1: DoBrazil folded before Flop (didn't bet)
Seat 2: thierryjc11 collected (€0.05)
Seat 3: ROGER20220 (button) folded before Flop (didn't bet)
Seat 4: Safakab (small blind) folded before Flop
Seat 5: mikrethor (big blind) folded on the Flop
Seat 6: ns68000 folded before Flop (didn't bet)



PokerStars Hand #109568474529:  Hold'em No Limit (€0.01/€0.02 EUR) - 2014/01/04 14:39:35 CET [2014/01/04 8:39:35 ET]
Table 'Ambrosia III' 6-max Seat #4 is the button
Seat 1: DoBrazil (€2.10 in chips) 
Seat 2: thierryjc11 (€1.11 in chips) 
Seat 3: ROGER20220 (€1.49 in chips) 
Seat 4: Safakab (€2.72 in chips) 
Seat 5: mikrethor (€2.94 in chips) 
Seat 6: ns68000 (€0.91 in chips) 
mikrethor: posts small blind €0.01
ns68000: posts big blind €0.02
*** HOLE CARDS ***
Dealt to mikrethor [8c 2d]
DoBrazil: calls €0.02
thierryjc11: calls €0.02
ROGER20220: raises €0.02 to €0.04
Safakab: folds 
mikrethor: folds 
ns68000: calls €0.02
DoBrazil: calls €0.02
thierryjc11: calls €0.02
*** FLOP *** [Kd 9d 8h]
ns68000: checks 
DoBrazil: checks 
thierryjc11: checks 
ROGER20220: checks 
*** TURN *** [Kd 9d 8h] [Tc]
ns68000: checks 
DoBrazil: checks 
thierryjc11: bets €0.02
ROGER20220: calls €0.02
ns68000: calls €0.02
DoBrazil: folds 
*** RIVER *** [Kd 9d 8h Tc] [4h]
ns68000: checks 
thierryjc11: bets €0.04
ROGER20220: folds 
ns68000: folds 
Uncalled bet (€0.04) returned to thierryjc11
thierryjc11 collected €0.22 from pot
thierryjc11: doesn't show hand 
*** SUMMARY ***
Total pot €0.23 | Rake €0.01 
Board [Kd 9d 8h Tc 4h]
Seat 1: DoBrazil folded on the Turn
Seat 2: thierryjc11 collected (€0.22)
Seat 3: ROGER20220 folded on the River
Seat 4: Safakab (button) folded before Flop (didn't bet)
Seat 5: mikrethor (small blind) folded before Flop
Seat 6: ns68000 (big blind) folded on the River



PokerStars Hand #109568532284:  Hold'em No Limit (€0.01/€0.02 EUR) - 2014/01/04 14:40:54 CET [2014/01/04 8:40:54 ET]
Table 'Ambrosia III' 6-max Seat #5 is the button
Seat 1: DoBrazil (€2.06 in chips) 
Seat 2: thierryjc11 (€1.27 in chips) 
Seat 3: ROGER20220 (€1.43 in chips) 
Seat 4: Safakab (€2.72 in chips) 
Seat 5: mikrethor (€2.93 in chips) 
Seat 6: ns68000 (€0.85 in chips) 
ns68000: posts small blind €0.01
DoBrazil: posts big blind €0.02
*** HOLE CARDS ***
Dealt to mikrethor [Qh Td]
thierryjc11: calls €0.02
ROGER20220: raises €0.04 to €0.06
Safakab: folds 
mikrethor: folds 
ns68000: folds 
DoBrazil: folds 
thierryjc11: calls €0.04
*** FLOP *** [4d 2c Ks]
thierryjc11: checks 
ROGER20220: bets €0.08
thierryjc11: calls €0.08
*** TURN *** [4d 2c Ks] [4c]
thierryjc11: checks 
ROGER20220: checks 
*** RIVER *** [4d 2c Ks 4c] [Jh]
thierryjc11: checks 
ROGER20220: checks 
*** SHOW DOWN ***
thierryjc11: shows [Kd Js] (two pair, Kings and Jacks)
ROGER20220: mucks hand 
thierryjc11 collected €0.29 from pot
*** SUMMARY ***
Total pot €0.31 | Rake €0.02 
Board [4d 2c Ks 4c Jh]
Seat 1: DoBrazil (big blind) folded before Flop
Seat 2: thierryjc11 showed [Kd Js] and won (€0.29) with two pair, Kings and Jacks
Seat 3: ROGER20220 mucked [5d 5s]
Seat 4: Safakab folded before Flop (didn't bet)
Seat 5: mikrethor (button) folded before Flop (didn't bet)
Seat 6: ns68000 (small blind) folded before Flop



PokerStars Hand #109568557206:  Hold'em No Limit (€0.01/€0.02 EUR) - 2014/01/04 14:41:28 CET [2014/01/04 8:41:28 ET]
Table 'Ambrosia III' 6-max Seat #6 is the button
Seat 1: DoBrazil (€2.04 in chips) 
Seat 2: thierryjc11 (€1.42 in chips) 
Seat 3: ROGER20220 (€1.29 in chips) 
Seat 4: Safakab (€2.72 in chips) 
Seat 5: mikrethor (€2.93 in chips) 
Seat 6: ns68000 (€0.84 in chips) 
DoBrazil: posts small blind €0.01
thierryjc11: posts big blind €0.02
*** HOLE CARDS ***
Dealt to mikrethor [8h 9c]
ROGER20220: folds 
Safakab: folds 
mikrethor: folds 
ns68000: folds 
DoBrazil: raises €0.06 to €0.08
thierryjc11: folds 
Uncalled bet (€0.06) returned to DoBrazil
DoBrazil collected €0.04 from pot
*** SUMMARY ***
Total pot €0.04 | Rake €0 
Seat 1: DoBrazil (small blind) collected (€0.04)
Seat 2: thierryjc11 (big blind) folded before Flop
Seat 3: ROGER20220 folded before Flop (didn't bet)
Seat 4: Safakab folded before Flop (didn't bet)
Seat 5: mikrethor folded before Flop (didn't bet)
Seat 6: ns68000 (button) folded before Flop (didn't bet)



PokerStars Hand #109568569154:  Hold'em No Limit (€0.01/€0.02 EUR) - 2014/01/04 14:41:44 CET [2014/01/04 8:41:44 ET]
Table 'Ambrosia III' 6-max Seat #1 is the button
Seat 1: DoBrazil (€2.06 in chips) 
Seat 2: thierryjc11 (€1.40 in chips) 
Seat 3: ROGER20220 (€1.29 in chips) 
Seat 4: Safakab (€2.72 in chips) 
Seat 5: mikrethor (€2.93 in chips) 
Seat 6: ns68000 (€0.84 in chips) 
thierryjc11: posts small blind €0.01
ROGER20220: posts big blind €0.02
*** HOLE CARDS ***
Dealt to mikrethor [7h Ks]
Safakab: folds 
mikrethor: folds 
ns68000: folds 
DoBrazil: folds 
thierryjc11: calls €0.01
ROGER20220: checks 
*** FLOP *** [9s 4d 3h]
thierryjc11: bets €0.04
ROGER20220: calls €0.04
*** TURN *** [9s 4d 3h] [2h]
thierryjc11: bets €0.02
ROGER20220: raises €0.02 to €0.04
thierryjc11: calls €0.02
*** RIVER *** [9s 4d 3h 2h] [7s]
thierryjc11: checks 
ROGER20220: checks 
*** SHOW DOWN ***
thierryjc11: shows [8c 6h] (high card Nine)
ROGER20220: shows [Kh Th] (high card King)
ROGER20220 collected €0.19 from pot
*** SUMMARY ***
Total pot €0.20 | Rake €0.01 
Board [9s 4d 3h 2h 7s]
Seat 1: DoBrazil (button) folded before Flop (didn't bet)
Seat 2: thierryjc11 (small blind) showed [8c 6h] and lost with high card Nine
Seat 3: ROGER20220 (big blind) showed [Kh Th] and won (€0.19) with high card King
Seat 4: Safakab folded before Flop (didn't bet)
Seat 5: mikrethor folded before Flop (didn't bet)
Seat 6: ns68000 folded before Flop (didn't bet)



PokerStars Hand #109568605506:  Hold'em No Limit (€0.01/€0.02 EUR) - 2014/01/04 14:42:34 CET [2014/01/04 8:42:34 ET]
Table 'Ambrosia III' 6-max Seat #2 is the button
Seat 1: DoBrazil (€2.06 in chips) 
Seat 2: thierryjc11 (€1.30 in chips) 
Seat 3: ROGER20220 (€1.38 in chips) 
Seat 4: Safakab (€2.72 in chips) 
Seat 5: mikrethor (€2.93 in chips) 
Seat 6: ns68000 (€0.84 in chips) 
ROGER20220: posts small blind €0.01
Safakab: posts big blind €0.02
*** HOLE CARDS ***
Dealt to mikrethor [7h 7c]
mikrethor: raises €0.06 to €0.08
ns68000: folds 
DoBrazil: folds 
thierryjc11: folds 
ROGER20220: folds 
Safakab: calls €0.06
*** FLOP *** [Qc Ts Ad]
Safakab: checks 
mikrethor: bets €0.08
Safakab: calls €0.08
*** TURN *** [Qc Ts Ad] [Jc]
Safakab: checks 
mikrethor: checks 
*** RIVER *** [Qc Ts Ad Jc] [5h]
Safakab: checks 
mikrethor: checks 
*** SHOW DOWN ***
Safakab: shows [Ah 6h] (a pair of Aces)
mikrethor: mucks hand 
Safakab collected €0.31 from pot
*** SUMMARY ***
Total pot €0.33 | Rake €0.02 
Board [Qc Ts Ad Jc 5h]
Seat 1: DoBrazil folded before Flop (didn't bet)
Seat 2: thierryjc11 (button) folded before Flop (didn't bet)
Seat 3: ROGER20220 (small blind) folded before Flop
Seat 4: Safakab (big blind) showed [Ah 6h] and won (€0.31) with a pair of Aces
Seat 5: mikrethor mucked [7h 7c]
Seat 6: ns68000 folded before Flop (didn't bet)



PokerStars Hand #109568647573:  Hold'em No Limit (€0.01/€0.02 EUR) - 2014/01/04 14:43:31 CET [2014/01/04 8:43:31 ET]
Table 'Ambrosia III' 6-max Seat #3 is the button
Seat 1: DoBrazil (€2.06 in chips) 
Seat 2: thierryjc11 (€1.30 in chips) 
Seat 3: ROGER20220 (€1.37 in chips) 
Seat 4: Safakab (€2.87 in chips) 
Seat 5: mikrethor (€2.77 in chips) 
Seat 6: ns68000 (€0.84 in chips) 
Safakab: posts small blind €0.01
mikrethor: posts big blind €0.02
*** HOLE CARDS ***
Dealt to mikrethor [Kh 2h]
ns68000: calls €0.02
DoBrazil: folds 
thierryjc11: calls €0.02
ROGER20220: folds 
Safakab: folds 
mikrethor: checks 
*** FLOP *** [3h 8d Ah]
mikrethor: checks 
ns68000: bets €0.02
thierryjc11: raises €0.10 to €0.12
mikrethor: calls €0.12
ns68000: calls €0.10
*** TURN *** [3h 8d Ah] [2d]
mikrethor: checks 
ns68000: bets €0.20
thierryjc11: raises €0.96 to €1.16 and is all-in
mikrethor: calls €1.16
ns68000: calls €0.50 and is all-in
*** RIVER *** [3h 8d Ah 2d] [8c]
*** SHOW DOWN ***
mikrethor: shows [Kh 2h] (two pair, Eights and Deuces)
thierryjc11: shows [8s 8h] (four of a kind, Eights)
thierryjc11 collected €0.86 from side pot
ns68000: shows [Ac Ts] (two pair, Aces and Eights)
thierryjc11 collected €2.38 from main pot
*** SUMMARY ***
Total pot €3.45 Main pot €2.38. Side pot €0.86. | Rake €0.21 
Board [3h 8d Ah 2d 8c]
Seat 1: DoBrazil folded before Flop (didn't bet)
Seat 2: thierryjc11 showed [8s 8h] and won (€3.24) with four of a kind, Eights
Seat 3: ROGER20220 (button) folded before Flop (didn't bet)
Seat 4: Safakab (small blind) folded before Flop
Seat 5: mikrethor (big blind) showed [Kh 2h] and lost with two pair, Eights and Deuces
Seat 6: ns68000 showed [Ac Ts] and lost with two pair, Aces and Eights



PokerStars Hand #109568677905:  Hold'em No Limit (€0.01/€0.02 EUR) - 2014/01/04 14:44:13 CET [2014/01/04 8:44:13 ET]
Table 'Ambrosia III' 6-max Seat #4 is the button
Seat 2: thierryjc11 (€3.24 in chips) 
Seat 3: ROGER20220 (€1.37 in chips) 
Seat 4: Safakab (€2.86 in chips) 
Seat 5: mikrethor (€1.47 in chips) 
mikrethor: posts small blind €0.01
DoBrazil: is sitting out 
thierryjc11: posts big blind €0.02
*** HOLE CARDS ***
Dealt to mikrethor [Qh Jh]
ROGER20220: calls €0.02
Safakab: raises €0.06 to €0.08
mikrethor: calls €0.07
thierryjc11: folds 
ROGER20220: folds 
*** FLOP *** [4h 3s Tc]
thierryjc11 leaves the table
mikrethor: checks 
ns68000 said, "sacree table de baltringue"
Safakab: bets €0.11
mikrethor: folds 
Uncalled bet (€0.11) returned to Safakab
Safakab collected €0.19 from pot
Safakab: doesn't show hand 
*** SUMMARY ***
Total pot €0.20 | Rake €0.01 
Board [4h 3s Tc]
Seat 2: thierryjc11 (big blind) folded before Flop
Seat 3: ROGER20220 folded before Flop
Seat 4: Safakab (button) collected (€0.19)
Seat 5: mikrethor (small blind) folded on the Flop



PokerStars Hand #109568699115:  Hold'em No Limit (€0.01/€0.02 EUR) - 2014/01/04 14:44:41 CET [2014/01/04 8:44:41 ET]
Table 'Ambrosia III' 6-max Seat #5 is the button
Seat 3: ROGER20220 (€1.35 in chips) 
Seat 4: Safakab (€2.97 in chips) 
Seat 5: mikrethor (€1.39 in chips) 
ns68000 will be allowed to play after the button
ROGER20220: posts small blind €0.01
Safakab: posts big blind €0.02
*** HOLE CARDS ***
Dealt to mikrethor [5s 2s]
mikrethor: folds 
tyty73190 joins the table at seat #2 
ROGER20220: calls €0.01
ns68000 said, "avec une paire de 8 sa relance pas"
Safakab: checks 
*** FLOP *** [Ad 4c Kd]
ROGER20220: bets €0.04
Safakab: folds 
Uncalled bet (€0.04) returned to ROGER20220
ROGER20220 collected €0.04 from pot
ROGER20220: doesn't show hand 
*** SUMMARY ***
Total pot €0.04 | Rake €0 
Board [Ad 4c Kd]
Seat 3: ROGER20220 (small blind) collected (€0.04)
Seat 4: Safakab (big blind) folded on the Flop
Seat 5: mikrethor (button) folded before Flop (didn't bet)



PokerStars Hand #109568714398:  Hold'em No Limit (€0.01/€0.02 EUR) - 2014/01/04 14:45:02 CET [2014/01/04 8:45:02 ET]
Table 'Ambrosia III' 6-max Seat #3 is the button
Seat 2: tyty73190 (€2 in chips) 
Seat 3: ROGER20220 (€1.37 in chips) 
Seat 4: Safakab (€2.95 in chips) 
Seat 5: mikrethor (€1.39 in chips) 
Seat 6: ns68000 (€1 in chips) 
Safakab: posts small blind €0.01
mikrethor: posts big blind €0.02
ns68000: posts small & big blinds €0.03
tyty73190: posts big blind €0.02
*** HOLE CARDS ***
Dealt to mikrethor [8d Jh]
ns68000: raises €0.08 to €0.10
tyty73190: calls €0.08
DoBrazil leaves the table
ROGER20220: folds 
ROGER20220 said, "PAS FAUX"
Safakab: folds 
mikrethor: folds 
*** FLOP *** [9s 4d 9h]
ns68000: bets €0.22
tyty73190: calls €0.22
*** TURN *** [9s 4d 9h] [Ts]
ns68000: bets €0.64
tyty73190: calls €0.64
*** RIVER *** [9s 4d 9h Ts] [7d]
ns68000: bets €0.03 and is all-in
tyty73190: calls €0.03
*** SHOW DOWN ***
ns68000: shows [Qd Qc] (two pair, Queens and Nines)
tyty73190: mucks hand 
ns68000 collected €1.90 from pot
*** SUMMARY ***
Total pot €2.02 | Rake €0.12 
Board [9s 4d 9h Ts 7d]
Seat 2: tyty73190 mucked [8s 8c]
Seat 3: ROGER20220 (button) folded before Flop (didn't bet)
Seat 4: Safakab (small blind) folded before Flop
Seat 5: mikrethor (big blind) folded before Flop
Seat 6: ns68000 showed [Qd Qc] and won (€1.90) with two pair, Queens and Nines



PokerStars Hand #109568756768:  Hold'em No Limit (€0.01/€0.02 EUR) - 2014/01/04 14:45:59 CET [2014/01/04 8:45:59 ET]
Table 'Ambrosia III' 6-max Seat #4 is the button
Seat 2: tyty73190 (€1.01 in chips) 
Seat 3: ROGER20220 (€1.37 in chips) 
Seat 4: Safakab (€2.94 in chips) 
Seat 5: mikrethor (€1.37 in chips) 
Seat 6: ns68000 (€1.90 in chips) 
mikrethor: posts small blind €0.01
ns68000: posts big blind €0.02
*** HOLE CARDS ***
Dealt to mikrethor [9c Kd]
tyty73190: calls €0.02
ROGER20220: folds 
Safakab: raises €0.06 to €0.08
mikrethor: folds 
ns68000: folds 
tyty73190: calls €0.06
*** FLOP *** [Ah 8c 4h]
tyty73190: checks 
Safakab: checks 
*** TURN *** [Ah 8c 4h] [Qd]
tyty73190: bets €0.10
Safakab: calls €0.10
*** RIVER *** [Ah 8c 4h Qd] [3s]
tyty73190: bets €0.36
Safakab: calls €0.36
*** SHOW DOWN ***
tyty73190: shows [8d Ad] (two pair, Aces and Eights)
Safakab: mucks hand 
tyty73190 collected €1.04 from pot
*** SUMMARY ***
Total pot €1.11 | Rake €0.07 
Board [Ah 8c 4h Qd 3s]
Seat 2: tyty73190 showed [8d Ad] and won (€1.04) with two pair, Aces and Eights
Seat 3: ROGER20220 folded before Flop (didn't bet)
Seat 4: Safakab (button) mucked [Ks Qh]
Seat 5: mikrethor (small blind) folded before Flop
Seat 6: ns68000 (big blind) folded before Flop



PokerStars Hand #109568788203:  Hold'em No Limit (€0.01/€0.02 EUR) - 2014/01/04 14:46:42 CET [2014/01/04 8:46:42 ET]
Table 'Ambrosia III' 6-max Seat #5 is the button
Seat 2: tyty73190 (€1.51 in chips) 
Seat 3: ROGER20220 (€1.37 in chips) 
Seat 4: Safakab (€2.40 in chips) 
Seat 5: mikrethor (€1.36 in chips) 
Seat 6: ns68000 (€1.88 in chips) 
ns68000: posts small blind €0.01
tyty73190: posts big blind €0.02
*** HOLE CARDS ***
Dealt to mikrethor [5h Jh]
ROGER20220: folds 
Safakab: raises €0.06 to €0.08
mikrethor: folds 
ns68000: folds 
tyty73190: calls €0.06
*** FLOP *** [7h 9d Tc]
tyty73190: checks 
Safakab: bets €0.11
tyty73190: calls €0.11
*** TURN *** [7h 9d Tc] [6s]
tyty73190: bets €0.36
Safakab: calls €0.36
*** RIVER *** [7h 9d Tc 6s] [6h]
tyty73190: bets €0.96 and is all-in
Safakab: calls €0.96
*** SHOW DOWN ***
tyty73190: shows [Qs Qc] (two pair, Queens and Sixes)
Safakab: shows [8h Ac] (a straight, Six to Ten)
Safakab collected €2.85 from pot
*** SUMMARY ***
Total pot €3.03 | Rake €0.18 
Board [7h 9d Tc 6s 6h]
Seat 2: tyty73190 (big blind) showed [Qs Qc] and lost with two pair, Queens and Sixes
Seat 3: ROGER20220 folded before Flop (didn't bet)
Seat 4: Safakab showed [8h Ac] and won (€2.85) with a straight, Six to Ten
Seat 5: mikrethor (button) folded before Flop (didn't bet)
Seat 6: ns68000 (small blind) folded before Flop



PokerStars Hand #109568818120:  Hold'em No Limit (€0.01/€0.02 EUR) - 2014/01/04 14:47:22 CET [2014/01/04 8:47:22 ET]
Table 'Ambrosia III' 6-max Seat #6 is the button
Seat 3: ROGER20220 (€1.37 in chips) 
Seat 4: Safakab (€3.74 in chips) 
Seat 5: mikrethor (€1.36 in chips) 
Seat 6: ns68000 (€1.87 in chips) 
ROGER20220: posts small blind €0.01
Safakab: posts big blind €0.02
*** HOLE CARDS ***
Dealt to mikrethor [Th Jc]
mikrethor: calls €0.02
tyty73190 leaves the table
ns68000: folds 
ROGER20220: calls €0.01
Safakab: raises €0.06 to €0.08
BomberMan900 joins the table at seat #2 
mikrethor: calls €0.06
ROGER20220: folds 
*** FLOP *** [Kd Tc 3s]
Safakab: checks 
mikrethor: bets €0.16
Prana_Bindu joins the table at seat #1 
Safakab: folds 
Uncalled bet (€0.16) returned to mikrethor
mikrethor collected €0.17 from pot
mikrethor: doesn't show hand 
*** SUMMARY ***
Total pot €0.18 | Rake €0.01 
Board [Kd Tc 3s]
Seat 3: ROGER20220 (small blind) folded before Flop
Seat 4: Safakab (big blind) folded on the Flop
Seat 5: mikrethor collected (€0.17)
Seat 6: ns68000 (button) folded before Flop (didn't bet)



PokerStars Hand #109568840304:  Hold'em No Limit (€0.01/€0.02 EUR) - 2014/01/04 14:47:52 CET [2014/01/04 8:47:52 ET]
Table 'Ambrosia III' 6-max Seat #3 is the button
Seat 2: BomberMan900 (€1.60 in chips) 
Seat 3: ROGER20220 (€1.35 in chips) 
Seat 4: Safakab (€3.66 in chips) 
Seat 5: mikrethor (€1.45 in chips) 
Seat 6: ns68000 (€1.87 in chips) 
Safakab: posts small blind €0.01
mikrethor: posts big blind €0.02
Prana_Bindu: sits out 
BomberMan900: posts big blind €0.02
*** HOLE CARDS ***
Dealt to mikrethor [2h 6h]
ns68000: folds 
BomberMan900: checks 
ROGER20220: raises €0.08 to €0.10
Safakab: calls €0.09
mikrethor: folds 
BomberMan900: folds 
*** FLOP *** [Ks Js Kc]
Safakab: checks 
ROGER20220: bets €0.08
Safakab: calls €0.08
*** TURN *** [Ks Js Kc] [5d]
Safakab: checks 
ROGER20220: bets €0.08
Safakab: calls €0.08
*** RIVER *** [Ks Js Kc 5d] [Qh]
Safakab: checks 
ROGER20220: checks 
*** SHOW DOWN ***
Safakab: shows [Ts Jh] (two pair, Kings and Jacks)
ROGER20220: mucks hand 
Safakab collected €0.53 from pot
*** SUMMARY ***
Total pot €0.56 | Rake €0.03 
Board [Ks Js Kc 5d Qh]
Seat 2: BomberMan900 folded before Flop
Seat 3: ROGER20220 (button) mucked [9s 9c]
Seat 4: Safakab (small blind) showed [Ts Jh] and won (€0.53) with two pair, Kings and Jacks
Seat 5: mikrethor (big blind) folded before Flop
Seat 6: ns68000 folded before Flop (didn't bet)



PokerStars Hand #109568869240:  Hold'em No Limit (€0.01/€0.02 EUR) - 2014/01/04 14:48:31 CET [2014/01/04 8:48:31 ET]
Table 'Ambrosia III' 6-max Seat #4 is the button
Seat 2: BomberMan900 (€1.58 in chips) 
Seat 3: ROGER20220 (€1.09 in chips) 
Seat 4: Safakab (€3.93 in chips) 
Seat 5: mikrethor (€1.43 in chips) 
Seat 6: ns68000 (€1.87 in chips) 
mikrethor: posts small blind €0.01
ns68000: posts big blind €0.02
Prana_Bindu: sits out 
*** HOLE CARDS ***
Dealt to mikrethor [Td Th]
BomberMan900: folds 
ROGER20220: calls €0.02
Safakab: folds 
mikrethor: raises €0.08 to €0.10
ns68000: folds 
ROGER20220: calls €0.08
*** FLOP *** [6c Ts 5d]
mikrethor: bets €0.02
ROGER20220: calls €0.02
*** TURN *** [6c Ts 5d] [5h]
mikrethor: bets €0.02
ROGER20220: calls €0.02
*** RIVER *** [6c Ts 5d 5h] [9h]
mikrethor: bets €0.28
ROGER20220: folds 
Uncalled bet (€0.28) returned to mikrethor
mikrethor collected €0.28 from pot
mikrethor: doesn't show hand 
*** SUMMARY ***
Total pot €0.30 | Rake €0.02 
Board [6c Ts 5d 5h 9h]
Seat 2: BomberMan900 folded before Flop (didn't bet)
Seat 3: ROGER20220 folded on the River
Seat 4: Safakab (button) folded before Flop (didn't bet)
Seat 5: mikrethor (small blind) collected (€0.28)
Seat 6: ns68000 (big blind) folded before Flop



PokerStars Hand #109568908361:  Hold'em No Limit (€0.01/€0.02 EUR) - 2014/01/04 14:49:25 CET [2014/01/04 8:49:25 ET]
Table 'Ambrosia III' 6-max Seat #5 is the button
Seat 1: Prana_Bindu (€2 in chips) 
Seat 2: BomberMan900 (€1.58 in chips) 
Seat 3: ROGER20220 (€0.95 in chips) 
Seat 4: Safakab (€3.93 in chips) 
Seat 5: mikrethor (€1.57 in chips) 
Seat 6: ns68000 (€1.85 in chips) 
ns68000: posts small blind €0.01
Prana_Bindu is disconnected 
Prana_Bindu is connected 
Prana_Bindu: posts big blind €0.02
*** HOLE CARDS ***
Dealt to mikrethor [8h 5h]
BomberMan900: folds 
ROGER20220: calls €0.02
Safakab: folds 
mikrethor: folds 
ns68000: calls €0.01
Prana_Bindu: checks 
*** FLOP *** [Td 3d Ks]
ns68000: checks 
Prana_Bindu: checks 
ROGER20220: bets €0.06
ns68000: folds 
Prana_Bindu: folds 
Uncalled bet (€0.06) returned to ROGER20220
ROGER20220 collected €0.06 from pot
ROGER20220: doesn't show hand 
*** SUMMARY ***
Total pot €0.06 | Rake €0 
Board [Td 3d Ks]
Seat 1: Prana_Bindu (big blind) folded on the Flop
Seat 2: BomberMan900 folded before Flop (didn't bet)
Seat 3: ROGER20220 collected (€0.06)
Seat 4: Safakab folded before Flop (didn't bet)
Seat 5: mikrethor (button) folded before Flop (didn't bet)
Seat 6: ns68000 (small blind) folded on the Flop



PokerStars Hand #109568950413:  Hold'em No Limit (€0.01/€0.02 EUR) - 2014/01/04 14:50:21 CET [2014/01/04 8:50:21 ET]
Table 'Ambrosia III' 6-max Seat #6 is the button
Seat 1: Prana_Bindu (€1.98 in chips) 
Seat 2: BomberMan900 (€1.58 in chips) 
Seat 3: ROGER20220 (€0.99 in chips) 
Seat 4: Safakab (€3.93 in chips) 
Seat 5: mikrethor (€1.57 in chips) 
Seat 6: ns68000 (€1.83 in chips) 
Prana_Bindu: posts small blind €0.01
BomberMan900: posts big blind €0.02
*** HOLE CARDS ***
Dealt to mikrethor [Ts Ac]
ROGER20220: folds 
Safakab: folds 
mikrethor: raises €0.06 to €0.08
ns68000: folds 
ns68000 leaves the table
Prana_Bindu: calls €0.07
BomberMan900: folds 
*** FLOP *** [Td Ad Tc]
labayts joins the table at seat #6 
Prana_Bindu: checks 
mikrethor: checks 
*** TURN *** [Td Ad Tc] [Qs]
Prana_Bindu: bets €0.08
mikrethor: raises €0.20 to €0.28
Prana_Bindu: calls €0.20
*** RIVER *** [Td Ad Tc Qs] [Ks]
Prana_Bindu: checks 
mikrethor: bets €0.70
Prana_Bindu: folds 
Uncalled bet (€0.70) returned to mikrethor
mikrethor collected €0.70 from pot
mikrethor: doesn't show hand 
*** SUMMARY ***
Total pot €0.74 | Rake €0.04 
Board [Td Ad Tc Qs Ks]
Seat 1: Prana_Bindu (small blind) folded on the River
Seat 2: BomberMan900 (big blind) folded before Flop
Seat 3: ROGER20220 folded before Flop (didn't bet)
Seat 4: Safakab folded before Flop (didn't bet)
Seat 5: mikrethor collected (€0.70)
Seat 6: ns68000 (button) folded before Flop (didn't bet)



PokerStars Hand #109568990727:  Hold'em No Limit (€0.01/€0.02 EUR) - 2014/01/04 14:51:16 CET [2014/01/04 8:51:16 ET]
Table 'Ambrosia III' 6-max Seat #1 is the button
Seat 1: Prana_Bindu (€2 in chips) 
Seat 2: BomberMan900 (€1.56 in chips) 
Seat 3: ROGER20220 (€0.99 in chips) 
Seat 4: Safakab (€3.93 in chips) 
Seat 5: mikrethor (€1.91 in chips) 
BomberMan900: posts small blind €0.01
ROGER20220: posts big blind €0.02
labayts: sits out 
*** HOLE CARDS ***
Dealt to mikrethor [6s Qh]
Safakab: raises €0.06 to €0.08
mikrethor: folds 
Prana_Bindu: folds 
BomberMan900: folds 
ROGER20220: raises €0.08 to €0.16
Safakab: raises €3.77 to €3.93 and is all-in
ROGER20220: calls €0.83 and is all-in
Uncalled bet (€2.94) returned to Safakab
*** FLOP *** [6d Td 8s]
*** TURN *** [6d Td 8s] [8d]
*** RIVER *** [6d Td 8s 8d] [5c]
*** SHOW DOWN ***
ROGER20220: shows [Kc Kh] (two pair, Kings and Eights)
Safakab: shows [Ks As] (a pair of Eights)
ROGER20220 collected €1.87 from pot
*** SUMMARY ***
Total pot €1.99 | Rake €0.12 
Board [6d Td 8s 8d 5c]
Seat 1: Prana_Bindu (button) folded before Flop (didn't bet)
Seat 2: BomberMan900 (small blind) folded before Flop
Seat 3: ROGER20220 (big blind) showed [Kc Kh] and won (€1.87) with two pair, Kings and Eights
Seat 4: Safakab showed [Ks As] and lost with a pair of Eights
Seat 5: mikrethor folded before Flop (didn't bet)



PokerStars Hand #109569012607:  Hold'em No Limit (€0.01/€0.02 EUR) - 2014/01/04 14:51:45 CET [2014/01/04 8:51:45 ET]
Table 'Ambrosia III' 6-max Seat #2 is the button
Seat 1: Prana_Bindu (€2 in chips) 
Seat 2: BomberMan900 (€1.55 in chips) 
Seat 3: ROGER20220 (€1.87 in chips) 
Seat 4: Safakab (€2.94 in chips) 
Seat 5: mikrethor (€1.91 in chips) 
ROGER20220: posts small blind €0.01
Safakab: posts big blind €0.02
labayts: sits out 
*** HOLE CARDS ***
Dealt to mikrethor [6h 7d]
mikrethor: folds 
Prana_Bindu: raises €0.04 to €0.06
BomberMan900: folds 
ROGER20220: folds 
Safakab: calls €0.04
*** FLOP *** [9d 5d 8s]
Safakab: checks 
Prana_Bindu: checks 
*** TURN *** [9d 5d 8s] [Ts]
Safakab: checks 
Prana_Bindu: checks 
*** RIVER *** [9d 5d 8s Ts] [3h]
Safakab: checks 
Prana_Bindu: checks 
*** SHOW DOWN ***
Safakab: shows [Kh Js] (high card King)
Prana_Bindu: shows [3c Ac] (a pair of Threes)
Prana_Bindu collected €0.12 from pot
*** SUMMARY ***
Total pot €0.13 | Rake €0.01 
Board [9d 5d 8s Ts 3h]
Seat 1: Prana_Bindu showed [3c Ac] and won (€0.12) with a pair of Threes
Seat 2: BomberMan900 (button) folded before Flop (didn't bet)
Seat 3: ROGER20220 (small blind) folded before Flop
Seat 4: Safakab (big blind) showed [Kh Js] and lost with high card King
Seat 5: mikrethor folded before Flop (didn't bet)



PokerStars Hand #109569046051:  Hold'em No Limit (€0.01/€0.02 EUR) - 2014/01/04 14:52:30 CET [2014/01/04 8:52:30 ET]
Table 'Ambrosia III' 6-max Seat #3 is the button
Seat 1: Prana_Bindu (€2.06 in chips) 
Seat 2: BomberMan900 (€1.55 in chips) 
Seat 3: ROGER20220 (€1.86 in chips) 
Seat 4: Safakab (€2.88 in chips) 
Seat 5: mikrethor (€1.91 in chips) 
Safakab: posts small blind €0.01
mikrethor: posts big blind €0.02
labayts: sits out 
*** HOLE CARDS ***
Dealt to mikrethor [9h 9d]
Prana_Bindu: folds 
BomberMan900: raises €0.04 to €0.06
ROGER20220: folds 
Safakab: folds 
mikrethor: raises €1.85 to €1.91 and is all-in
BomberMan900: calls €1.49 and is all-in
Uncalled bet (€0.36) returned to mikrethor
*** FLOP *** [9s 9c 2h]
*** TURN *** [9s 9c 2h] [5d]
*** RIVER *** [9s 9c 2h 5d] [4s]
*** SHOW DOWN ***
mikrethor: shows [9h 9d] (four of a kind, Nines)
BomberMan900: mucks hand 
mikrethor collected €2.92 from pot
*** SUMMARY ***
Total pot €3.11 | Rake €0.19 
Board [9s 9c 2h 5d 4s]
Seat 1: Prana_Bindu folded before Flop (didn't bet)
Seat 2: BomberMan900 mucked [Jc Jd]
Seat 3: ROGER20220 (button) folded before Flop (didn't bet)
Seat 4: Safakab (small blind) folded before Flop
Seat 5: mikrethor (big blind) showed [9h 9d] and won (€2.92) with four of a kind, Nines



PokerStars Hand #109569063776:  Hold'em No Limit (€0.01/€0.02 EUR) - 2014/01/04 14:52:54 CET [2014/01/04 8:52:54 ET]
Table 'Ambrosia III' 6-max Seat #4 is the button
Seat 1: Prana_Bindu (€2.06 in chips) 
Seat 3: ROGER20220 (€1.86 in chips) 
Seat 4: Safakab (€2.87 in chips) 
Seat 5: mikrethor (€3.28 in chips) 
Seat 6: labayts (€2 in chips) 
mikrethor: posts small blind €0.01
labayts: posts big blind €0.02
*** HOLE CARDS ***
Dealt to mikrethor [9d As]
Prana_Bindu: raises €0.04 to €0.06
ROGER20220: folds 
Safakab: folds 
mikrethor: calls €0.05
labayts: folds 
*** FLOP *** [7c Qs 9c]
mikrethor: bets €0.06
Prana_Bindu: calls €0.06
*** TURN *** [7c Qs 9c] [6d]
mikrethor: bets €0.12
Prana_Bindu: folds 
Uncalled bet (€0.12) returned to mikrethor
mikrethor collected €0.24 from pot
mikrethor: doesn't show hand 
*** SUMMARY ***
Total pot €0.26 | Rake €0.02 
Board [7c Qs 9c 6d]
Seat 1: Prana_Bindu folded on the Turn
Seat 3: ROGER20220 folded before Flop (didn't bet)
Seat 4: Safakab (button) folded before Flop (didn't bet)
Seat 5: mikrethor (small blind) collected (€0.24)
Seat 6: labayts (big blind) folded before Flop



